NOTE: Some of these tickers may no longer be supported

ticker	Name	Exchange	type
AUDUSD=X	AUD/USD	CCY	CURRENCY_PAIR
AUDCHF=X	AUD/CHF	CCY	CURRENCY_PAIR
AUDNZD=X	AUD/NZD	CCY	CURRENCY_PAIR
AUDEUR=X	AUD/EUR	CCY	CURRENCY_PAIR
AUDTWD=X	AUD/TWD	CCY	CURRENCY_PAIR
AUDMXN=X	AUD/MXN	CCY	CURRENCY_PAIR
AUDJPY=X	AUD/JPY	CCY	CURRENCY_PAIR
NZDJPY=X	NZD/JPY	CCY	CURRENCY_PAIR
EURXAF=X	EUR/XAF	CCY	CURRENCY_PAIR
EURPEN=X	EUR/PEN	CCY	CURRENCY_PAIR
EURBDT=X	EUR/BDT	CCY	CURRENCY_PAIR
CAD=X	USD/CAD	CCY	CURRENCY_PAIR
AZNUSD=X	AZN/USD	CCY	CURRENCY_PAIR
AZNCHF=X	AZN/CHF	CCY	CURRENCY_PAIR
AUDSCR=X	AUD/SCR	CCY	CURRENCY_PAIR
AUDMOP=X	AUD/MOP	CCY	CURRENCY_PAIR
AUDKRW=X	AUD/KRW	CCY	CURRENCY_PAIR
AUDHNL=X	AUD/HNL	CCY	CURRENCY_PAIR
AUDGIP=X	AUD/GIP	CCY	CURRENCY_PAIR
AUDGBP=X	AUD/GBP	CCY	CURRENCY_PAIR
AUDCZK=X	AUD/CZK	CCY	CURRENCY_PAIR
AUDCLP=X	AUD/CLP	CCY	CURRENCY_PAIR
AUDCAD=X	AUD/CAD	CCY	CURRENCY_PAIR
ARSKRW=X	ARS/KRW	CCY	CURRENCY_PAIR
ARSGBP=X	ARS/GBP	CCY	CURRENCY_PAIR
ALLGBP=X	ALL/GBP	CCY	CURRENCY_PAIR
AEDTWD=X	AED/TWD	CCY	CURRENCY_PAIR
AEDSEK=X	AED/SEK	CCY	CURRENCY_PAIR
AEDQAR=X	AED/QAR	CCY	CURRENCY_PAIR
AEDOMR=X	AED/OMR	CCY	CURRENCY_PAIR
AEDMXN=X	AED/MXN	CCY	CURRENCY_PAIR
AEDMAD=X	AED/MAD	CCY	CURRENCY_PAIR
AEDLTL=X	AED/LTL	CCY	CURRENCY_PAIR
AEDKWD=X	AED/KWD	CCY	CURRENCY_PAIR
AEDHKD=X	AED/HKD	CCY	CURRENCY_PAIR
AEDCNY=X	AED/CNY	CCY	CURRENCY_PAIR
AEDAUD=X	AED/AUD	CCY	CURRENCY_PAIR
AEDKRW=X	AED/KRW	CCY	CURRENCY_PAIR
XF000EURCOP7.SG			CURRENCY_PAIR
AEDUSD=X	AED/USD	CCY	CURRENCY_PAIR
ARSCOP=X	ARS/COP	CCY	CURRENCY_PAIR
AUDRON=X	AUD/RON	CCY	CURRENCY_PAIR
ARSUSD=X	ARS/USD	CCY	CURRENCY_PAIR
AEDISK=X	AED/ISK	CCY	CURRENCY_PAIR
AEDLVL=X	AED/LVL	CCY	CURRENCY_PAIR
EURUYU=X	EUR/UYU	CCY	CURRENCY_PAIR
EUR-BDT.F	EUR-BDT.F		CURRENCY_PAIR
AEDPHP=X	AED/PHP	CCY	CURRENCY_PAIR
AEDCAD=X	AED/CAD	CCY	CURRENCY_PAIR
HU32.EX			CURRENCY_PAIR
AUTIE.SW			CURRENCY_PAIR
AUDBMD=X	AUD/BMD	CCY	CURRENCY_PAIR
ARSCLP=X	ARS/CLP	CCY	CURRENCY_PAIR
AWG=X	USD/AWG	CCY	CURRENCY_PAIR
AUDVEF=X	AUD/VEF	CCY	CURRENCY_PAIR
ANGEUR=X	ANG/EUR	CCY	CURRENCY_PAIR
AEDSGD=X	AED/SGD	CCY	CURRENCY_PAIR
AEDKES=X	AED/KES	CCY	CURRENCY_PAIR
AEDNZD=X	AED/NZD	CCY	CURRENCY_PAIR
ANGZAR=X	ANG/ZAR	CCY	CURRENCY_PAIR
EUR-TRY.F	EUR-TRY.F	FRA	CURRENCY_PAIR
ARSHKD=X	ARS/HKD	CCY	CURRENCY_PAIR
HG12.EX			CURRENCY_PAIR
AUDMAD=X	AUD/MAD	CCY	CURRENCY_PAIR
AUDTND=X	AUD/TND	CCY	CURRENCY_PAIR
AUDMGA=X	AUD/MGA	CCY	CURRENCY_PAIR
AUD=X	USD/AUD	CCY	CURRENCY_PAIR
AUDILS=X	AUD/ILS	CCY	CURRENCY_PAIR
ARSMXN=X	ARS/MXN	CCY	CURRENCY_PAIR
AUDOMR=X	AUD/OMR	CCY	CURRENCY_PAIR
ARSVEF=X	ARS/VEF	CCY	CURRENCY_PAIR
AUDRUB=X	AUD/RUB	CCY	CURRENCY_PAIR
AUDLVL=X	AUD/LVL	CCY	CURRENCY_PAIR
AEDBHD=X	AED/BHD	CCY	CURRENCY_PAIR
EURJOD=X	EUR/JOD	CCY	CURRENCY_PAIR
ALLEUR=X	ALL/EUR	CCY	CURRENCY_PAIR
881347.VI	881347.VI	VIE	CURRENCY_PAIR
AUDBWP=X	AUD/BWP	CCY	CURRENCY_PAIR
AUBEZ.SW			CURRENCY_PAIR
AUDGHS=X	AUD/GHS	CCY	CURRENCY_PAIR
HF52.EX	HF52.EX	EUX	CURRENCY_PAIR
AUDCRC=X	AUD/CRC	CCY	CURRENCY_PAIR
ANGCHF=X	ANG/CHF	CCY	CURRENCY_PAIR
EUR-KZT.F	EUR-KZT.F	FRA	CURRENCY_PAIR
AUDIDR=X	AUD/IDR	CCY	CURRENCY_PAIR
AUDQAR=X	AUD/QAR	CCY	CURRENCY_PAIR
AFN=X	USD/AFN	CCY	CURRENCY_PAIR
EUR-PEN.F	EUR-PEN.F		CURRENCY_PAIR
AUDSYP=X	AUD/SYP	CCY	CURRENCY_PAIR
AEDCZK=X	AED/CZK	CCY	CURRENCY_PAIR
ARSPYG=X	ARS/PYG	CCY	CURRENCY_PAIR
AEDNOK=X	AED/NOK	CCY	CURRENCY_PAIR
AUDPLN=X	AUD/PLN	CCY	CURRENCY_PAIR
EUR-MUR.F	EUR-MUR.F		CURRENCY_PAIR
AUDINR=X	AUD/INR	CCY	CURRENCY_PAIR
AEDTND=X	AED/TND	CCY	CURRENCY_PAIR
AEDXDR=X	AED/XDR	CCY	CURRENCY_PAIR
AUDXCD=X	AUD/XCD	CCY	CURRENCY_PAIR
EUR-BWP.F	EUR-BWP.F		CURRENCY_PAIR
HU42.EX			CURRENCY_PAIR
EUR-COP.F	EUR-COP.F		CURRENCY_PAIR
AUDTTD=X	AUD/TTD	CCY	CURRENCY_PAIR
AUDANG=X	AUD/ANG	CCY	CURRENCY_PAIR
AUDFJD=X	AUD/FJD	CCY	CURRENCY_PAIR
AEDPKR=X	AED/PKR	CCY	CURRENCY_PAIR
AUDEGP=X	AUD/EGP	CCY	CURRENCY_PAIR
ALLUSD=X	ALL/USD	CCY	CURRENCY_PAIR
AUDHKD=X	AUD/HKD	CCY	CURRENCY_PAIR
AUDKYD=X	AUD/KYD	CCY	CURRENCY_PAIR
AEDTRY=X	AED/TRY	CCY	CURRENCY_PAIR
AUDAV.SW			CURRENCY_PAIR
AEDTHB=X	AED/THB	CCY	CURRENCY_PAIR
AEDRUB=X	AED/RUB	CCY	CURRENCY_PAIR
AUDBHD=X	AUD/BHD	CCY	CURRENCY_PAIR
AEDPLN=X	AED/PLN	CCY	CURRENCY_PAIR
EURKES=X	EUR/KES	CCY	CURRENCY_PAIR
AEDGBP=X	AED/GBP	CCY	CURRENCY_PAIR
HU22.EX			CURRENCY_PAIR
AUDDOP=X	AUD/DOP	CCY	CURRENCY_PAIR
HU52.EX			CURRENCY_PAIR
HF32.EX			CURRENCY_PAIR
AUDSGD=X	AUD/SGD	CCY	CURRENCY_PAIR
EURBZD=X	EUR/BZD	CCY	CURRENCY_PAIR
EUR-HRK.F	EUR/HRK	FRA	CURRENCY_PAIR
EUR-LBP.F	EUR-LBP.F		CURRENCY_PAIR
AUDUYU=X	AUD/UYU	CCY	CURRENCY_PAIR
AUDMUR=X	AUD/MUR	CCY	CURRENCY_PAIR
AUHOE.SW			CURRENCY_PAIR
EUR-KES.F	EUR-KES.F		CURRENCY_PAIR
AEDILS=X	AED/ILS	CCY	CURRENCY_PAIR
EURKZT=X	EUR/KZT	CCY	CURRENCY_PAIR
AUDERN=X	AUD/ERN	CCY	CURRENCY_PAIR
IACWE.NX			CURRENCY_PAIR
EURTRY=X	EUR/TRY	CCY	CURRENCY_PAIR
AUDLTL=X	AUD/LTL	CCY	CURRENCY_PAIR
ARSUYU=X	ARS/UYU	CCY	CURRENCY_PAIR
C3AR.EX			CURRENCY_PAIR
EURCOP=X	EUR/COP	CCY	CURRENCY_PAIR
AOAUSD=X	AOA/USD	CCY	CURRENCY_PAIR
AFNCHF=X	AFN/CHF	CCY	CURRENCY_PAIR
AUDCNH=X	AUD/CNH	CCY	CURRENCY_PAIR
ARSPEN=X	ARS/PEN	CCY	CURRENCY_PAIR
EUR-BMD.F	EUR-BMD.F		CURRENCY_PAIR
11150067.DE			CURRENCY_PAIR
ARSCHF=X	ARS/CHF	CCY	CURRENCY_PAIR
AZN=X	USD/AZN	CCY	CURRENCY_PAIR
AUDAED=X	AUD/AED	CCY	CURRENCY_PAIR
AUDMYR=X	AUD/MYR	CCY	CURRENCY_PAIR
AUDNOK=X	AUD/NOK	CCY	CURRENCY_PAIR
29134330=X			CURRENCY_PAIR
EURBWP=X	EUR/BWP	CCY	CURRENCY_PAIR
AUDBZD=X	AUD/BZD	CCY	CURRENCY_PAIR
ARSBRL=X	ARS/BRL	CCY	CURRENCY_PAIR
ANGGBP=X	ANG/GBP	CCY	CURRENCY_PAIR
EUR-BOB.F	EUR-BOB.F		CURRENCY_PAIR
EUR-UYU.F	EUR-UYU.F	FRA	CURRENCY_PAIR
AUDSAR=X	AUD/SAR	CCY	CURRENCY_PAIR
AZNGBP=X	AZN/GBP	CCY	CURRENCY_PAIR
AUDLKR=X	AUD/LKR	CCY	CURRENCY_PAIR
AEDLKR=X	AED/LKR	CCY	CURRENCY_PAIR
AEDHUF=X	AED/HUF	CCY	CURRENCY_PAIR
AUDGTQ=X	AUD/GTQ	CCY	CURRENCY_PAIR
AEDEUR=X	AED/EUR	CCY	CURRENCY_PAIR
AUDXDR=X	AUD/XDR	CCY	CURRENCY_PAIR
AEDJPY=X	AED/JPY	CCY	CURRENCY_PAIR
AEDINR=X	AED/INR	CCY	CURRENCY_PAIR
AUDHUF=X	AUD/HUF	CCY	CURRENCY_PAIR
AMD=X	USD/AMD	CCY	CURRENCY_PAIR
AUDRSD=X	AUD/RSD	CCY	CURRENCY_PAIR
AEDMUR=X	AED/MUR	CCY	CURRENCY_PAIR
AUDPYG=X	AUD/PYG	CCY	CURRENCY_PAIR
ARSAUD=X	ARS/AUD	CCY	CURRENCY_PAIR
ARSJPY=X	ARS/JPY	CCY	CURRENCY_PAIR
AOAGBP=X	AOA/GBP	CCY	CURRENCY_PAIR
AUDHRK=X	AUD/HRK	CCY	CURRENCY_PAIR
CNY=X	USD/CNY	CCY	CURRENCY_PAIR
AUDXPF=X	AUD/XPF	CCY	CURRENCY_PAIR
29134331=X			CURRENCY_PAIR
ARSBOB=X	ARS/BOB	CCY	CURRENCY_PAIR
EURBMD=X	EUR/BMD	CCY	CURRENCY_PAIR
AWGCHF=X	AWG/CHF	CCY	CURRENCY_PAIR
ANGSRD=X	ANG/SRD	CCY	CURRENCY_PAIR
ARSCAD=X	ARS/CAD	CCY	CURRENCY_PAIR
ARS=X	USD/ARS	CCY	CURRENCY_PAIR
AUDPHP=X	AUD/PHP	CCY	CURRENCY_PAIR
ANG=X	USD/ANG	CCY	CURRENCY_PAIR
AEDZAR=X	AED/ZAR	CCY	CURRENCY_PAIR
ARSEUR=X	ARS/EUR	CCY	CURRENCY_PAIR
IACWE.PA	SPDR ACWE INAV	PAR	CURRENCY_PAIR
AED=X	USD/AED	CCY	CURRENCY_PAIR
AUDJOD=X	AUD/JOD	CCY	CURRENCY_PAIR
EUR-BZD.F	EUR-BZD.F		CURRENCY_PAIR
AUKOT.SW	AUKOT.SW	EBS	CURRENCY_PAIR
AEDEGP=X	UAE Dirham (b) vs Egyptian Poun	CCY	CURRENCY_PAIR
AUDTJS=X	AUD/TJS	CCY	CURRENCY_PAIR
EUR-ZMK.F	EUR-ZMK.F		CURRENCY_PAIR
AWGEUR=X	AWG/EUR	CCY	CURRENCY_PAIR
ANGCAD=X	ANG/CAD	CCY	CURRENCY_PAIR
AUDPKR=X	AUD/PKR	CCY	CURRENCY_PAIR
AEDJOD=X	AED/JOD	CCY	CURRENCY_PAIR
ARSTHB=X	ARS/THB	CCY	CURRENCY_PAIR
EURHRK=X	EUR/HRK	CCY	CURRENCY_PAIR
EURLBP=X	EUR/LBP	CCY	CURRENCY_PAIR
ARSDKK=X	ARS/DKK	CCY	CURRENCY_PAIR
AWGGBP=X	AWG/GBP	CCY	CURRENCY_PAIR
AUDTHB=X	AUD/THB	CCY	CURRENCY_PAIR
AUDBOB=X	AUD/BOB	CCY	CURRENCY_PAIR
EUR-XAF.F	EUR-XAF.F		CURRENCY_PAIR
AFNUSD=X	AFN/USD	CCY	CURRENCY_PAIR
AUDJMD=X	AUD/JMD	CCY	CURRENCY_PAIR
AEDSAR=X	AED/SAR	CCY	CURRENCY_PAIR
AUDKWD=X	AUD/KWD	CCY	CURRENCY_PAIR
AOA=X	USD/AOA	CCY	CURRENCY_PAIR
AUDISK=X	AUD/ISK	CCY	CURRENCY_PAIR
985840=X			CURRENCY_PAIR
EURMUR=X	EUR/MUR	CCY	CURRENCY_PAIR
AUDDKK=X	AUD/DKK	CCY	CURRENCY_PAIR
AUGLE.SW	AUGLE.SW	EBS	CURRENCY_PAIR
AUDKES=X	AUD/KES	CCY	CURRENCY_PAIR
AEDDKK=X	AED/DKK	CCY	CURRENCY_PAIR
ARSSGD=X	ARS/SGD	CCY	CURRENCY_PAIR
EUR-JOD.F	EUR-JOD.F		CURRENCY_PAIR
AEDIDR=X	AED/IDR	CCY	CURRENCY_PAIR
AUDTMT=X	AUD/TMT	CCY	CURRENCY_PAIR
AUDUGX=X	AUD/UGX	CCY	CURRENCY_PAIR
AUDBRL=X	AUD/BRL	CCY	CURRENCY_PAIR
AOACHF=X	AOA/CHF	CCY	CURRENCY_PAIR
AUDARS=X	AUD/ARS	CCY	CURRENCY_PAIR
XF000EURPEN5.SG			CURRENCY_PAIR
AUDAWG=X	AUD/AWG	CCY	CURRENCY_PAIR
AUDCNY=X	AUD/CNY	CCY	CURRENCY_PAIR
AWGUSD=X	AWG/USD	CCY	CURRENCY_PAIR
EURBOB=X	EUR/BOB	CCY	CURRENCY_PAIR
HF42.EX			CURRENCY_PAIR
AUDZAR=X	AUD/ZAR	CCY	CURRENCY_PAIR
AEDCHF=X	AED/CHF	CCY	CURRENCY_PAIR
AUDPEN=X	AUD/PEN	CCY	CURRENCY_PAIR
AEDIQD=X	AED/IQD	CCY	CURRENCY_PAIR
AUDBAM=X	AUD/BAM	CCY	CURRENCY_PAIR
AOAEUR=X	AOA/EUR	CCY	CURRENCY_PAIR
ANGUSD=X	ANG/USD	CCY	CURRENCY_PAIR
AZNEUR=X	AZN/EUR	CCY	CURRENCY_PAIR
AUDBBD=X	AUD/BBD	CCY	CURRENCY_PAIR
AUDSVC=X	AUD/SVC	CCY	CURRENCY_PAIR
AUDCOP=X	AUD/COP	CCY	CURRENCY_PAIR
ALL=X	USD/ALL	CCY	CURRENCY_PAIR
AFNEUR=X	AFN/EUR	CCY	CURRENCY_PAIR
ALLCHF=X	ALL/CHF	CCY	CURRENCY_PAIR
AUDBSD=X	AUD/BSD	CCY	CURRENCY_PAIR
AUDTRY=X	AUD/TRY	CCY	CURRENCY_PAIR
AUDSEK=X	AUD/SEK	CCY	CURRENCY_PAIR
BTCUSD=X	Bitcoin USD	CCY	CURRENCY_PAIR
BWPMAD=X	BWP/MAD	CCY	CURRENCY_PAIR
BWPKYD=X	BWP/KYD	CCY	CURRENCY_PAIR
BWPISK=X	BWP/ISK	CCY	CURRENCY_PAIR
BWPINR=X	BWP/INR	CCY	CURRENCY_PAIR
BWPIDR=X	BWP/IDR	CCY	CURRENCY_PAIR
BWPFJD=X	BWP/FJD	CCY	CURRENCY_PAIR
BWPEUR=X	BWP/EUR	CCY	CURRENCY_PAIR
BWPBDT=X	BWP/BDT	CCY	CURRENCY_PAIR
BRLINR=X	BRL/INR	CCY	CURRENCY_PAIR
BOBVEF=X	BOB/VEF	CCY	CURRENCY_PAIR
BOBUSD=X	BOB/USD	CCY	CURRENCY_PAIR
BOBPEN=X	BOB/PEN	CCY	CURRENCY_PAIR
BOBCOP=X	BOB/COP	CCY	CURRENCY_PAIR
BOBCHF=X	BOB/CHF	CCY	CURRENCY_PAIR
BMDUSD=X	BMD/USD	CCY	CURRENCY_PAIR
BMD=X	USD/BMD	CCY	CURRENCY_PAIR
BHDOMR=X	BHD/OMR	CCY	CURRENCY_PAIR
BHDJPY=X	BHD/JPY	CCY	CURRENCY_PAIR
BHDEUR=X	BHD/EUR	CCY	CURRENCY_PAIR
BHDCHF=X	BHD/CHF	CCY	CURRENCY_PAIR
BHDAED=X	BHD/AED	CCY	CURRENCY_PAIR
BBDDKK=X	BBD/DKK	CCY	CURRENCY_PAIR
BWPNGN=X	BWP/NGN	CCY	CURRENCY_PAIR
BWPTOP=X	BWP/TOP	CCY	CURRENCY_PAIR
BWPGBP=X	BWP/GBP	CCY	CURRENCY_PAIR
BTN=X	USD/BTN	CCY	CURRENCY_PAIR
29134332=X			CURRENCY_PAIR
BWPHUF=X	BWP/HUF	CCY	CURRENCY_PAIR
BND=X	USD/BND	CCY	CURRENCY_PAIR
BNDGBP=X	BND/GBP	CCY	CURRENCY_PAIR
BRLCAD=X	BRL/CAD	CCY	CURRENCY_PAIR
BRLRUB=X	BRL/RUB	CCY	CURRENCY_PAIR
BM.PA			CURRENCY_PAIR
BWPMUR=X	BWP/MUR	CCY	CURRENCY_PAIR
BAMGBP=X	BAM/GBP	CCY	CURRENCY_PAIR
BTNUSD=X	BTN/USD	CCY	CURRENCY_PAIR
BRLPEN=X	BRL/PEN	CCY	CURRENCY_PAIR
BWPTRY=X	BWP/TRY	CCY	CURRENCY_PAIR
BWPSEK=X	BWP/SEK	CCY	CURRENCY_PAIR
BMDDKK=X	BMD/DKK	CCY	CURRENCY_PAIR
GDEBQ.MDD			CURRENCY_PAIR
BWPAUD=X	BWP/AUD	CCY	CURRENCY_PAIR
BWPXDR=X	BWP/XDR	CCY	CURRENCY_PAIR
BHDXDR=X	BHD/XDR	CCY	CURRENCY_PAIR
BWPRUB=X	BWP/RUB	CCY	CURRENCY_PAIR
IDEBY.MDD			CURRENCY_PAIR
BRLCHF=X	BRL/CHF	CCY	CURRENCY_PAIR
BOB=X	USD/BOB	CCY	CURRENCY_PAIR
EOB.PA			CURRENCY_PAIR
BMDGBP=X	BMD/GBP	CCY	CURRENCY_PAIR
BRLDKK=X	BRL/DKK	CCY	CURRENCY_PAIR
BWPCHF=X	BWP/CHF	CCY	CURRENCY_PAIR
BRLMYR=X	BRL/MYR	CCY	CURRENCY_PAIR
BDTHKD=X	BDT/HKD	CCY	CURRENCY_PAIR
BDTCAD=X	BDT/CAD	CCY	CURRENCY_PAIR
BWPKES=X	BWP/KES	CCY	CURRENCY_PAIR
BWPCNY=X	BWP/CNY	CCY	CURRENCY_PAIR
BWPMYR=X	BWP/MYR	CCY	CURRENCY_PAIR
BRLHKD=X	BRL/HKD	CCY	CURRENCY_PAIR
BHDNZD=X	BHD/NZD	CCY	CURRENCY_PAIR
BRLTHB=X	BRL/THB	CCY	CURRENCY_PAIR
BWPPGK=X	BWP/PGK	CCY	CURRENCY_PAIR
BWPRSD=X	BWP/RSD	CCY	CURRENCY_PAIR
BAMEUR=X	BAM/EUR	CCY	CURRENCY_PAIR
BBDUSD=X	BBD/USD	CCY	CURRENCY_PAIR
BHDSAR=X	BHD/SAR	CCY	CURRENCY_PAIR
BWPZMW=X	BWP/ZMW	CCY	CURRENCY_PAIR
BWPBMD=X	BWP/BMD	CCY	CURRENCY_PAIR
BZDGBP=X	BZD/GBP	CCY	CURRENCY_PAIR
BWPOMR=X	BWP/OMR	CCY	CURRENCY_PAIR
BRLCNY=X	BRL/CNY	CCY	CURRENCY_PAIR
GDEBM.MDD	GDEBM.MDD	MDD	CURRENCY_PAIR
BWPRON=X	BWP/RON	CCY	CURRENCY_PAIR
BGNGBP=X	BGN/GBP	CCY	CURRENCY_PAIR
BOBUYU=X	BOB/UYU	CCY	CURRENCY_PAIR
BRLTRY=X	BRL/TRY	CCY	CURRENCY_PAIR
BHD=X	USD/BHD	CCY	CURRENCY_PAIR
BNDIDR=X	BND/IDR	CCY	CURRENCY_PAIR
BWPNOK=X	BWP/NOK	CCY	CURRENCY_PAIR
BTNGBP=X	BTN/GBP	CCY	CURRENCY_PAIR
BRLEUR=X	BRL/EUR	CCY	CURRENCY_PAIR
BWPTZS=X	BWP/TZS	CCY	CURRENCY_PAIR
BOBBRL=X	BOB/BRL	CCY	CURRENCY_PAIR
BZDCHF=X	BZD/CHF	CCY	CURRENCY_PAIR
BWPCLF=X	BWP/CLF	CCY	CURRENCY_PAIR
BWPBGN=X	BWP/BGN	CCY	CURRENCY_PAIR
BSDCAD=X	BSD/CAD	CCY	CURRENCY_PAIR
BNDUSD=X	BND/USD	CCY	CURRENCY_PAIR
BWPMWK=X	BWP/MWK	CCY	CURRENCY_PAIR
BWPZAR=X	BWP/ZAR	CCY	CURRENCY_PAIR
BWPHKD=X	BWP/HKD	CCY	CURRENCY_PAIR
BZD=X	USD/BZD	CCY	CURRENCY_PAIR
BWP=X	USD/BWP	CCY	CURRENCY_PAIR
BRLUYU=X	BRL/UYU	CCY	CURRENCY_PAIR
BGNCHF=X	BGN/CHF	CCY	CURRENCY_PAIR
ENDK.IR			CURRENCY_PAIR
BWPBHD=X	BWP/BHD	CCY	CURRENCY_PAIR
CHBEZ.SW	CHBEZ.SW	EBS	CURRENCY_PAIR
BBDEUR=X	BBD/EUR	CCY	CURRENCY_PAIR
BWPNAD=X	BWP/NAD	CCY	CURRENCY_PAIR
BIF=X	USD/BIF	CCY	CURRENCY_PAIR
BRLZAR=X	BRL/ZAR	CCY	CURRENCY_PAIR
BAMCHF=X	BAM/CHF	CCY	CURRENCY_PAIR
BDTSGD=X	BDT/SGD	CCY	CURRENCY_PAIR
BOBMXN=X	BOB/MXN	CCY	CURRENCY_PAIR
BWPKZT=X	BWP/KZT	CCY	CURRENCY_PAIR
BDT=X	USD/BDT	CCY	CURRENCY_PAIR
GDEBY.MDD			CURRENCY_PAIR
BWPXOF=X	BWP/XOF	CCY	CURRENCY_PAIR
BRLSGD=X	BRL/SGD	CCY	CURRENCY_PAIR
BSDGBP=X	BSD/GBP	CCY	CURRENCY_PAIR
BWPJOD=X	BWP/JOD	CCY	CURRENCY_PAIR
BBDCHF=X	BBD/CHF	CCY	CURRENCY_PAIR
BRLARS=X	BRL/ARS	CCY	CURRENCY_PAIR
BWPJPY=X	BWP/JPY	CCY	CURRENCY_PAIR
BNDCHF=X	BND/CHF	CCY	CURRENCY_PAIR
BRLILS=X	BRL/ILS	CCY	CURRENCY_PAIR
BWPPEN=X	BWP/PEN	CCY	CURRENCY_PAIR
BZDEUR=X	BZD/EUR	CCY	CURRENCY_PAIR
BWPPKR=X	BWP/PKR	CCY	CURRENCY_PAIR
BWPSGD=X	BWP/SGD	CCY	CURRENCY_PAIR
BMS.PA	BMS.PA	PAR	CURRENCY_PAIR
BWPAED=X	BWP/AED	CCY	CURRENCY_PAIR
BRLCOP=X	BRL/COP	CCY	CURRENCY_PAIR
BRLIDR=X	BRL/IDR	CCY	CURRENCY_PAIR
BWPCOP=X	BWP/COP	CCY	CURRENCY_PAIR
BWPKWD=X	BWP/KWD	CCY	CURRENCY_PAIR
BNDXDR=X	BND/XDR	CCY	CURRENCY_PAIR
BHDPKR=X	BHD/PKR	CCY	CURRENCY_PAIR
BNDDKK=X	BND/DKK	CCY	CURRENCY_PAIR
BWPCNH=X	BWP/CNH	CCY	CURRENCY_PAIR
BGNPLN=X	BGN/PLN	CCY	CURRENCY_PAIR
BHDUSD=X	BHD/USD	CCY	CURRENCY_PAIR
BHDQAR=X	BHD/QAR	CCY	CURRENCY_PAIR
BBDGBP=X	BBD/GBP	CCY	CURRENCY_PAIR
BWPCZK=X	BWP/CZK	CCY	CURRENCY_PAIR
BWPTHB=X	BWP/THB	CCY	CURRENCY_PAIR
BYR=X	USD/BYR	CCY	CURRENCY_PAIR
BWPLKR=X	BWP/LKR	CCY	CURRENCY_PAIR
BDTUSD=X	BDT/USD	CCY	CURRENCY_PAIR
BHDHKD=X	BHD/HKD	CCY	CURRENCY_PAIR
BWPSBD=X	BWP/SBD	CCY	CURRENCY_PAIR
BRLMXN=X	BRL/MXN	CCY	CURRENCY_PAIR
BWPKRW=X	BWP/KRW	CCY	CURRENCY_PAIR
BWPUGX=X	BWP/UGX	CCY	CURRENCY_PAIR
BWPUSD=X	BWP/USD	CCY	CURRENCY_PAIR
BAMUSD=X	BAM/USD	CCY	CURRENCY_PAIR
BTNEUR=X	BTN/EUR	CCY	CURRENCY_PAIR
BRLPYG=X	BRL/PYG	CCY	CURRENCY_PAIR
BWPTWD=X	BWP/TWD	CCY	CURRENCY_PAIR
BDTJPY=X	BDT/JPY	CCY	CURRENCY_PAIR
BOBEUR=X	BOB/EUR	CCY	CURRENCY_PAIR
BHDGBP=X	BHD/GBP	CCY	CURRENCY_PAIR
BGNEUR=X	BGN/EUR	CCY	CURRENCY_PAIR
BRLUSD=X	BRL/USD	CCY	CURRENCY_PAIR
BWPGHS=X	BWP/GHS	CCY	CURRENCY_PAIR
BRLSEK=X	BRL/SEK	CCY	CURRENCY_PAIR
BHDSGD=X	BHD/SGD	CCY	CURRENCY_PAIR
BAM=X	USD/BAM	CCY	CURRENCY_PAIR
BZDUSD=X	BZD/USD	CCY	CURRENCY_PAIR
BWPRWF=X	BWP/RWF	CCY	CURRENCY_PAIR
BGN=X	USD/BGN	CCY	CURRENCY_PAIR
IDEBQ.MDD			CURRENCY_PAIR
BBD=X	USD/BBD	CCY	CURRENCY_PAIR
IDEBM.MDD			CURRENCY_PAIR
BWPTND=X	BWP/TND	CCY	CURRENCY_PAIR
BWPILS=X	BWP/ILS	CCY	CURRENCY_PAIR
BRLKRW=X	BRL/KRW	CCY	CURRENCY_PAIR
BWPANG=X	BWP/ANG	CCY	CURRENCY_PAIR
BOBPYG=X	BOB/PYG	CCY	CURRENCY_PAIR
BRLVEF=X	BRL/VEF	CCY	CURRENCY_PAIR
BWPHRK=X	BWP/HRK	CCY	CURRENCY_PAIR
BWPCLP=X	BWP/CLP	CCY	CURRENCY_PAIR
BWPAFN=X	BWP/AFN	CCY	CURRENCY_PAIR
BSDUSD=X	BSD/USD	CCY	CURRENCY_PAIR
BOBARS=X	BOB/ARS	CCY	CURRENCY_PAIR
BDTGBP=X	BDT/GBP	CCY	CURRENCY_PAIR
BSDCHF=X	BSD/CHF	CCY	CURRENCY_PAIR
BWPMXN=X	BWP/MXN	CCY	CURRENCY_PAIR
BWPDKK=X	BWP/DKK	CCY	CURRENCY_PAIR
BWPCAD=X	BWP/CAD	CCY	CURRENCY_PAIR
BOBGBP=X	BOB/GBP	CCY	CURRENCY_PAIR
BDTSEK=X	BDT/SEK	CCY	CURRENCY_PAIR
BWPSAR=X	BWP/SAR	CCY	CURRENCY_PAIR
BHDDKK=X	BHD/DKK	CCY	CURRENCY_PAIR
BSDEUR=X	BSD/EUR	CCY	CURRENCY_PAIR
BGNTRY=X	BGN/TRY	CCY	CURRENCY_PAIR
BRLJPY=X	BRL/JPY	CCY	CURRENCY_PAIR
BWPPHP=X	BWP/PHP	CCY	CURRENCY_PAIR
BRLGBP=X	BRL/GBP	CCY	CURRENCY_PAIR
BGNCZK=X	BGN/CZK	CCY	CURRENCY_PAIR
BRL=X	USD/BRL	CCY	CURRENCY_PAIR
BDTCHF=X	BDT/CHF	CCY	CURRENCY_PAIR
BHDKWD=X	BHD/KWD	CCY	CURRENCY_PAIR
BWPMOP=X	BWP/MOP	CCY	CURRENCY_PAIR
BDTEUR=X	BDT/EUR	CCY	CURRENCY_PAIR
BSD=X	USD/BSD	CCY	CURRENCY_PAIR
BGNTHB=X	BGN/THB	CCY	CURRENCY_PAIR
BWPBRL=X	BWP/BRL	CCY	CURRENCY_PAIR
BGNUSD=X	BGN/USD	CCY	CURRENCY_PAIR
BWPZWL=X	BWP/ZWL	CCY	CURRENCY_PAIR
BSDDKK=X	BSD/DKK	CCY	CURRENCY_PAIR
BNDEUR=X	BND/EUR	CCY	CURRENCY_PAIR
BWPEGP=X	BWP/EGP	CCY	CURRENCY_PAIR
BWPNZD=X	BWP/NZD	CCY	CURRENCY_PAIR
BRLXDR=X	BRL/XDR	CCY	CURRENCY_PAIR
BWPWST=X	BWP/WST	CCY	CURRENCY_PAIR
BOBCLP=X	BOB/CLP	CCY	CURRENCY_PAIR
BMDEUR=X	BMD/EUR	CCY	CURRENCY_PAIR
BRLNZD=X	BRL/NZD	CCY	CURRENCY_PAIR
BRLAUD=X	BRL/AUD	CCY	CURRENCY_PAIR
BWPARS=X	BWP/ARS	CCY	CURRENCY_PAIR
BRLBOB=X	BRL/BOB	CCY	CURRENCY_PAIR
BGNDKK=X	BGN/DKK	CCY	CURRENCY_PAIR
BGNLVL=X	BGN/LVL	CCY	CURRENCY_PAIR
BRLNOK=X	BRL/NOK	CCY	CURRENCY_PAIR
BMDCHF=X	BMD/CHF	CCY	CURRENCY_PAIR
BRLCLP=X	BRL/CLP	CCY	CURRENCY_PAIR
BWPVND=X	BWP/VND	CCY	CURRENCY_PAIR
BWPQAR=X	BWP/QAR	CCY	CURRENCY_PAIR
CADUSD=X	CAD/USD	CCY	CURRENCY_PAIR
CHFUSD=X	CHF/USD	CCY	CURRENCY_PAIR
CNYUSD=X	CNY/USD	CCY	CURRENCY_PAIR
CHFEUR=X	CHF/EUR	CCY	CURRENCY_PAIR
NZDGBP=X	NZD/GBP	CCY	CURRENCY_PAIR
CVECHF=X	CVE/CHF	CCY	CURRENCY_PAIR
CHFJPY=X	CHF/JPY	CCY	CURRENCY_PAIR
CADJPY=X	CAD/JPY	CCY	CURRENCY_PAIR
ZARSGD=X	ZAR/SGD	CCY	CURRENCY_PAIR
ZARSEK=X	ZAR/SEK	CCY	CURRENCY_PAIR
ZARMYR=X	ZAR/MYR	CCY	CURRENCY_PAIR
ZARJPY=X	ZAR/JPY	CCY	CURRENCY_PAIR
ZARCAD=X	ZAR/CAD	CCY	CURRENCY_PAIR
ZARAUD=X	ZAR/AUD	CCY	CURRENCY_PAIR
NZDCAD=X	NZD/CAD	CCY	CURRENCY_PAIR
NOKZAR=X	NOK/ZAR	CCY	CURRENCY_PAIR
NOKJPY=X	NOK/JPY	CCY	CURRENCY_PAIR
NOKGBP=X	NOK/GBP	CCY	CURRENCY_PAIR
JPYTRY=X	JPY/TRY	CCY	CURRENCY_PAIR
EURDOP=X	EUR/DOP	CCY	CURRENCY_PAIR
CZKZAR=X	CZK/ZAR	CCY	CURRENCY_PAIR
CZKRSD=X	CZK/RSD	CCY	CURRENCY_PAIR
CZKPHP=X	CZK/PHP	CCY	CURRENCY_PAIR
CZKLKR=X	CZK/LKR	CCY	CURRENCY_PAIR
CZKHKD=X	CZK/HKD	CCY	CURRENCY_PAIR
CZKBRL=X	CZK/BRL	CCY	CURRENCY_PAIR
CZKBGN=X	CZK/BGN	CCY	CURRENCY_PAIR
CZKBDT=X	CZK/BDT	CCY	CURRENCY_PAIR
CVE=X	USD/CVE	CCY	CURRENCY_PAIR
CUPGBP=X	CUP/GBP	CCY	CURRENCY_PAIR
CUP=X	USD/CUP	CCY	CURRENCY_PAIR
COPTHB=X	COP/THB	CCY	CURRENCY_PAIR
CNYTRY=X	CNY/TRY	CCY	CURRENCY_PAIR
CNYPHP=X	CNY/PHP	CCY	CURRENCY_PAIR
CNYLTL=X	CNY/LTL	CCY	CURRENCY_PAIR
CNYJPY=X	CNY/JPY	CCY	CURRENCY_PAIR
CNYILS=X	CNY/ILS	CCY	CURRENCY_PAIR
CNYGHS=X	CNY/GHS	CCY	CURRENCY_PAIR
CNYBWP=X	CNY/BWP	CCY	CURRENCY_PAIR
CNYAED=X	CNY/AED	CCY	CURRENCY_PAIR
CNHUSD=X	CNH/USD	CCY	CURRENCY_PAIR
CLF=X	USD/CLF	CCY	CURRENCY_PAIR
CHFZAR=X	CHF/ZAR	CCY	CURRENCY_PAIR
CHFVND=X	CHF/VND	CCY	CURRENCY_PAIR
CHFUAH=X	CHF/UAH	CCY	CURRENCY_PAIR
CHFTRY=X	CHF/TRY	CCY	CURRENCY_PAIR
CHFSOS=X	CHF/SOS	CCY	CURRENCY_PAIR
CHFMUR=X	CHF/MUR	CCY	CURRENCY_PAIR
CHFMKD=X	CHF/MKD	CCY	CURRENCY_PAIR
CHFMDL=X	CHF/MDL	CCY	CURRENCY_PAIR
CHFKPW=X	CHF/KPW	CCY	CURRENCY_PAIR
CHFIRR=X	CHF/IRR	CCY	CURRENCY_PAIR
CHFHRK=X	CHF/HRK	CCY	CURRENCY_PAIR
CHFBYR=X	CHF/BYR	CCY	CURRENCY_PAIR
CHFBND=X	CHF/BND	CCY	CURRENCY_PAIR
CHFBAM=X	CHF/BAM	CCY	CURRENCY_PAIR
CHFAWG=X	CHF/AWG	CCY	CURRENCY_PAIR
CADZAR=X	CAD/ZAR	CCY	CURRENCY_PAIR
CADWST=X	CAD/WST	CCY	CURRENCY_PAIR
CADTZS=X	CAD/TZS	CCY	CURRENCY_PAIR
CADTWD=X	CAD/TWD	CCY	CURRENCY_PAIR
CADTND=X	CAD/TND	CCY	CURRENCY_PAIR
CADSGD=X	CAD/SGD	CCY	CURRENCY_PAIR
CADSBD=X	CAD/SBD	CCY	CURRENCY_PAIR
CADSAR=X	CAD/SAR	CCY	CURRENCY_PAIR
CADRUB=X	CAD/RUB	CCY	CURRENCY_PAIR
CADRSD=X	CAD/RSD	CCY	CURRENCY_PAIR
CADPLN=X	CAD/PLN	CCY	CURRENCY_PAIR
CADNZD=X	CAD/NZD	CCY	CURRENCY_PAIR
CADMVR=X	CAD/MVR	CCY	CURRENCY_PAIR
CADMDL=X	CAD/MDL	CCY	CURRENCY_PAIR
CADLRD=X	CAD/LRD	CCY	CURRENCY_PAIR
CADKZT=X	CAD/KZT	CCY	CURRENCY_PAIR
CADKES=X	CAD/KES	CCY	CURRENCY_PAIR
CADGYD=X	CAD/GYD	CCY	CURRENCY_PAIR
CADGIP=X	CAD/GIP	CCY	CURRENCY_PAIR
CADGBP=X	CAD/GBP	CCY	CURRENCY_PAIR
CADEUR=X	CAD/EUR	CCY	CURRENCY_PAIR
CADCHF=X	CAD/CHF	CCY	CURRENCY_PAIR
CADAMD=X	CAD/AMD	CCY	CURRENCY_PAIR
CADAFN=X	CAD/AFN	CCY	CURRENCY_PAIR
CLFJPY=X	CLF/JPY	CCY	CURRENCY_PAIR
CNYAUD=X	CNY/AUD	CCY	CURRENCY_PAIR
CHFNAD=X	CHF/NAD	CCY	CURRENCY_PAIR
CADKYD=X	CAD/KYD	CCY	CURRENCY_PAIR
CLFEUR=X	CLF/EUR	CCY	CURRENCY_PAIR
EURDZD=X	EUR/DZD	CCY	CURRENCY_PAIR
CHFZMK=X			CURRENCY_PAIR
NZDSEK=X	NZD/SEK	CCY	CURRENCY_PAIR
CADMGA=X	CAD/MGA	CCY	CURRENCY_PAIR
CHFRSD=X	CHF/RSD	CCY	CURRENCY_PAIR
11667427.SW	11667427.SW	EBS	CURRENCY_PAIR
CHFBIF=X	CHF/BIF	CCY	CURRENCY_PAIR
CNH=X	USD/CNH	CCY	CURRENCY_PAIR
CZKVUV=X	CZK/VUV	CCY	CURRENCY_PAIR
CHFCLP=X	CHF/CLP	CCY	CURRENCY_PAIR
CHFAZN=X	CHF/AZN	CCY	CURRENCY_PAIR
CNYKES=X	CNY/KES	CCY	CURRENCY_PAIR
CZKMYR=X	CZK/MYR	CCY	CURRENCY_PAIR
CHFILS=X	CHF/ILS	CCY	CURRENCY_PAIR
CNYSEK=X	CNY/SEK	CCY	CURRENCY_PAIR
CZKINR=X	CZK/INR	CCY	CURRENCY_PAIR
CHFKYD=X	CHF/KYD	CCY	CURRENCY_PAIR
CHFUYU=X	CHF/UYU	CCY	CURRENCY_PAIR
CHFARS=X	CHF/ARS	CCY	CURRENCY_PAIR
CNYUGX=X	CNY/UGX	CCY	CURRENCY_PAIR
EUR-ILS.F	EUR-ILS.F		CURRENCY_PAIR
CADMOP=X	CAD/MOP	CCY	CURRENCY_PAIR
CZKARS=X	CZK/ARS	CCY	CURRENCY_PAIR
CHFUGX=X	CHF/UGX	CCY	CURRENCY_PAIR
CADTRY=X	CAD/TRY	CCY	CURRENCY_PAIR
CHFAMD=X	CHF/AMD	CCY	CURRENCY_PAIR
CADTTD=X	CAD/TTD	CCY	CURRENCY_PAIR
CADYER=X	CAD/YER	CCY	CURRENCY_PAIR
CADBMD=X	CAD/BMD	CCY	CURRENCY_PAIR
CADVEF=X	CAD/VEF	CCY	CURRENCY_PAIR
CHFVEF=X	CHF/VEF	CCY	CURRENCY_PAIR
CHFCUP=X	CHF/CUP	CCY	CURRENCY_PAIR
CHFTJS=X	CHF/TJS	CCY	CURRENCY_PAIR
CHFPGK=X	CHF/PGK	CCY	CURRENCY_PAIR
CADPYG=X	CAD/PYG	CCY	CURRENCY_PAIR
CZKKES=X	CZK/KES	CCY	CURRENCY_PAIR
CZKISK=X	CZK/ISK	CCY	CURRENCY_PAIR
EUR-MNT.F	EUR-MNT.F	FRA	CURRENCY_PAIR
CHFPAB=X	CHF/PAB	CCY	CURRENCY_PAIR
CNHINR=X	CNH/INR	CCY	CURRENCY_PAIR
CZKVEF=X	CZK/VEF	CCY	CURRENCY_PAIR
CADSHP=X	CAD/SHP	CCY	CURRENCY_PAIR
CZKJOD=X	CZK/JOD	CCY	CURRENCY_PAIR
CHFEGP=X	CHF/EGP	CCY	CURRENCY_PAIR
CADBTN=X	CAD/BTN	CCY	CURRENCY_PAIR
CADPAB=X	CAD/PAB	CCY	CURRENCY_PAIR
CZKBAM=X	CZK/BAM	CCY	CURRENCY_PAIR
CHFKHR=X	CHF/KHR	CCY	CURRENCY_PAIR
CNYMXN=X	CNY/MXN	CCY	CURRENCY_PAIR
CADBIF=X	CAD/BIF	CCY	CURRENCY_PAIR
CHFGBP=X	CHF/GBP	CCY	CURRENCY_PAIR
CZKBND=X	CZK/BND	CCY	CURRENCY_PAIR
CZKJPY=X	CZK/JPY	CCY	CURRENCY_PAIR
CADUAH=X	CAD/UAH	CCY	CURRENCY_PAIR
CHFRUB=X	CHF/RUB	CCY	CURRENCY_PAIR
CADBDT=X	CAD/BDT	CCY	CURRENCY_PAIR
CHFDZD=X	CHF/DZD	CCY	CURRENCY_PAIR
CHFNPR=X	CHF/NPR	CCY	CURRENCY_PAIR
CNYGBP=X	CNY/GBP	CCY	CURRENCY_PAIR
19666227.SW			CURRENCY_PAIR
CHFDEM=X	CHF/DEM	CCY	CURRENCY_PAIR
19663223.SW			CURRENCY_PAIR
CNYMUR=X	CNY/MUR	CCY	CURRENCY_PAIR
CNYJOD=X	CNY/JOD	CCY	CURRENCY_PAIR
CLPJPY=X	CLP/JPY	CCY	CURRENCY_PAIR
CNYDKK=X	CNY/DKK	CCY	CURRENCY_PAIR
CADAWG=X	CAD/AWG	CCY	CURRENCY_PAIR
CHFBZD=X	CHF/BZD	CCY	CURRENCY_PAIR
CHFBRL=X	CHF/BRL	CCY	CURRENCY_PAIR
CNHGBP=X	CNH/GBP	CCY	CURRENCY_PAIR
CHFXAF=X	CHF/XAF	CCY	CURRENCY_PAIR
2219069=X			CURRENCY_PAIR
CUPUSD=X	CUP/USD	CCY	CURRENCY_PAIR
CADSZL=X	CAD/SZL	CCY	CURRENCY_PAIR
CADPGK=X	CAD/PGK	CCY	CURRENCY_PAIR
CHFSYP=X	CHF/SYP	CCY	CURRENCY_PAIR
NOKNZD=X	NOK/NZD	CCY	CURRENCY_PAIR
CADFKP=X	CAD/FKP	CCY	CURRENCY_PAIR
CHFNOK=X	CHF/NOK	CCY	CURRENCY_PAIR
CADKMF=X	CAD/KMF	CCY	CURRENCY_PAIR
CADCNY=X	CAD/CNY	CCY	CURRENCY_PAIR
CHFLYD=X	CHF/LYD	CCY	CURRENCY_PAIR
RSO.PA	RSO.PA	PAR	CURRENCY_PAIR
CHFLRD=X	CHF/LRD	CCY	CURRENCY_PAIR
ZARNZD=X	ZAR/NZD	CCY	CURRENCY_PAIR
CADMMK=X	CAD/MMK	CCY	CURRENCY_PAIR
CZKNZD=X	CZK/NZD	CCY	CURRENCY_PAIR
CHFMOP=X	CHF/MOP	CCY	CURRENCY_PAIR
CHFKGS=X	CHF/KGS	CCY	CURRENCY_PAIR
CHFMGA=X	CHF/MGA	CCY	CURRENCY_PAIR
CNYXDR=X	CNY/XDR	CCY	CURRENCY_PAIR
CNYLVL=X	CNY/LVL	CCY	CURRENCY_PAIR
CHFHKD=X	CHF/HKD	CCY	CURRENCY_PAIR
CADXCD=X	CAD/XCD	CCY	CURRENCY_PAIR
CHFOMR=X	CHF/OMR	CCY	CURRENCY_PAIR
CADMRO=X	CAD/MRO	CCY	CURRENCY_PAIR
CADNOK=X	CAD/NOK	CCY	CURRENCY_PAIR
CHFHUF=X	CHF/HUF	CCY	CURRENCY_PAIR
CADAOA=X	CAD/AOA	CCY	CURRENCY_PAIR
CADSLL=X	CAD/SLL	CCY	CURRENCY_PAIR
EURILS=X	EUR/ILS	CCY	CURRENCY_PAIR
CNYKRW=X	CNY/KRW	CCY	CURRENCY_PAIR
CADFJD=X	CAD/FJD	CCY	CURRENCY_PAIR
CLPBRL=X	CLP/BRL	CCY	CURRENCY_PAIR
CZKTHB=X	CZK/THB	CCY	CURRENCY_PAIR
CADBSD=X	CAD/BSD	CCY	CURRENCY_PAIR
EUR-GEL.F	EUR-GEL.F		CURRENCY_PAIR
CHFFJD=X	CHF/FJD	CCY	CURRENCY_PAIR
CADANG=X	CAD/ANG	CCY	CURRENCY_PAIR
CHFCAD=X	CHF/CAD	CCY	CURRENCY_PAIR
CHFMVR=X	CHF/MVR	CCY	CURRENCY_PAIR
CZKBHD=X	CZK/BHD	CCY	CURRENCY_PAIR
CADZMW=X	CAD/ZMW	CCY	CURRENCY_PAIR
CNHSGD=X	CNH/SGD	CCY	CURRENCY_PAIR
CADBND=X	CAD/BND	CCY	CURRENCY_PAIR
CHFBWP=X	CHF/BWP	CCY	CURRENCY_PAIR
CZKTND=X	CZK/TND	CCY	CURRENCY_PAIR
CADPHP=X	CAD/PHP	CCY	CURRENCY_PAIR
CADSEK=X	CAD/SEK	CCY	CURRENCY_PAIR
CNYCAD=X	CNY/CAD	CCY	CURRENCY_PAIR
CHFSHP=X	CHF/SHP	CCY	CURRENCY_PAIR
CUPEUR=X	CUP/EUR	CCY	CURRENCY_PAIR
CNYZAR=X	CNY/ZAR	CCY	CURRENCY_PAIR
CHFGHS=X	CHF/GHS	CCY	CURRENCY_PAIR
CZK=X	USD/CZK	CCY	CURRENCY_PAIR
CHFJOD=X	CHF/JOD	CCY	CURRENCY_PAIR
CHFNZD=X	CHF/NZD	CCY	CURRENCY_PAIR
CZKHUF=X	CZK/HUF	CCY	CURRENCY_PAIR
CDF=X	USD/CDF	CCY	CURRENCY_PAIR
CHFWST=X	CHF/WST	CCY	CURRENCY_PAIR
CADSRD=X	CAD/SRD	CCY	CURRENCY_PAIR
CADCLP=X	CAD/CLP	CCY	CURRENCY_PAIR
HKDSEK=X	HKD/SEK	CCY	CURRENCY_PAIR
CHFMZN=X	CHF/MZN	CCY	CURRENCY_PAIR
CHFPYG=X	CHF/PYG	CCY	CURRENCY_PAIR
CADLVL=X	CAD/LVL	CCY	CURRENCY_PAIR
CADLTL=X	CAD/LTL	CCY	CURRENCY_PAIR
CADMUR=X	CAD/MUR	CCY	CURRENCY_PAIR
CNYEUR=X	CNY/EUR	CCY	CURRENCY_PAIR
13750330.SW	13750330.SW	EBS	CURRENCY_PAIR
SGDSEK=X	SGD/SEK	CCY	CURRENCY_PAIR
CZKGBP=X	CZK/GBP	CCY	CURRENCY_PAIR
CHFSRD=X	CHF/SRD	CCY	CURRENCY_PAIR
CADLKR=X	CAD/LKR	CCY	CURRENCY_PAIR
CHFGNF=X	CHF/GNF	CCY	CURRENCY_PAIR
CHFERN=X	CHF/ERN	CCY	CURRENCY_PAIR
NOKCAD=X	NOK/CAD	CCY	CURRENCY_PAIR
CHF=X	USD/CHF	CCY	CURRENCY_PAIR
CHFKRW=X	CHF/KRW	CCY	CURRENCY_PAIR
CZKUSD=X	CZK/USD	CCY	CURRENCY_PAIR
CHFXOF=X	CHF/XOF	CCY	CURRENCY_PAIR
CNHKRW=X	CNH/KRW	CCY	CURRENCY_PAIR
CADLBP=X	CAD/LBP	CCY	CURRENCY_PAIR
CHFLKR=X	CHF/LKR	CCY	CURRENCY_PAIR
19666222.SW			CURRENCY_PAIR
ZARNOK=X	ZAR/NOK	CCY	CURRENCY_PAIR
CADAZN=X	CAD/AZN	CCY	CURRENCY_PAIR
CHFALL=X	CHF/ALL	CCY	CURRENCY_PAIR
3017024.EX			CURRENCY_PAIR
CZKSGD=X	CZK/SGD	CCY	CURRENCY_PAIR
CZKKWD=X	CZK/KWD	CCY	CURRENCY_PAIR
29134333=X			CURRENCY_PAIR
ZARHKD=X	ZAR/HKD	CCY	CURRENCY_PAIR
CLPCOP=X	CLP/COP	CCY	CURRENCY_PAIR
CADBRL=X	CAD/BRL	CCY	CURRENCY_PAIR
3017005.EX			CURRENCY_PAIR
CADVND=X	CAD/VND	CCY	CURRENCY_PAIR
CNYSAR=X	CNY/SAR	CCY	CURRENCY_PAIR
CNYNZD=X	CNY/NZD	CCY	CURRENCY_PAIR
11667437.SW			CURRENCY_PAIR
CADNIO=X	CAD/NIO	CCY	CURRENCY_PAIR
CHFKES=X	CHF/KES	CCY	CURRENCY_PAIR
CHFBMD=X	CHF/BMD	CCY	CURRENCY_PAIR
CZKIDR=X	CZK/IDR	CCY	CURRENCY_PAIR
CLPDKK=X	CLP/DKK	CCY	CURRENCY_PAIR
CADIDR=X	CAD/IDR	CCY	CURRENCY_PAIR
CNYMAD=X	CNY/MAD	CCY	CURRENCY_PAIR
CNYIDR=X	CNY/IDR	CCY	CURRENCY_PAIR
CZKTRY=X	CZK/TRY	CCY	CURRENCY_PAIR
CHFPHP=X	CHF/PHP	CCY	CURRENCY_PAIR
CHFJMD=X	CHF/JMD	CCY	CURRENCY_PAIR
CADKWD=X	CAD/KWD	CCY	CURRENCY_PAIR
CADUGX=X	CAD/UGX	CCY	CURRENCY_PAIR
CADUZS=X	CAD/UZS	CCY	CURRENCY_PAIR
CADNPR=X	CAD/NPR	CCY	CURRENCY_PAIR
CHFRON=X	CHF/RON	CCY	CURRENCY_PAIR
CNYTWD=X	CNY/TWD	CCY	CURRENCY_PAIR
CHFTHB=X	CHF/THB	CCY	CURRENCY_PAIR
CADMZN=X	CAD/MZN	CCY	CURRENCY_PAIR
CZKKRW=X	CZK/KRW	CCY	CURRENCY_PAIR
CHFMMK=X	CHF/MMK	CCY	CURRENCY_PAIR
CNHTWD=X	CNH/TWD	CCY	CURRENCY_PAIR
COPMXN=X	COP/MXN	CCY	CURRENCY_PAIR
ILSEUR=X	ILS/EUR	CCY	CURRENCY_PAIR
CADMYR=X	CAD/MYR	CCY	CURRENCY_PAIR
CADISK=X	CAD/ISK	CCY	CURRENCY_PAIR
CZKEUR=X	CZK/EUR	CCY	CURRENCY_PAIR
CZKAUD=X	CZK/AUD	CCY	CURRENCY_PAIR
CADTJS=X	CAD/TJS	CCY	CURRENCY_PAIR
CHFCRC=X	CHF/CRC	CCY	CURRENCY_PAIR
CHFISK=X	CHF/ISK	CCY	CURRENCY_PAIR
CNYBRL=X	CNY/BRL	CCY	CURRENCY_PAIR
CHFTWD=X	CHF/TWD	CCY	CURRENCY_PAIR
CZKUYU=X	CZK/UYU	CCY	CURRENCY_PAIR
CADMKD=X	CAD/MKD	CCY	CURRENCY_PAIR
CZKLTL=X	CZK/LTL	CCY	CURRENCY_PAIR
CHFTTD=X	CHF/TTD	CCY	CURRENCY_PAIR
CADCRC=X	CAD/CRC	CCY	CURRENCY_PAIR
CHFBDT=X	CHF/BDT	CCY	CURRENCY_PAIR
CNYNOK=X	CNY/NOK	CCY	CURRENCY_PAIR
CADKRW=X	CAD/KRW	CCY	CURRENCY_PAIR
ZARGBP=X	ZAR/GBP	CCY	CURRENCY_PAIR
CHFSLL=X	CHF/SLL	CCY	CURRENCY_PAIR
9B4B.MU	9B4B.MU	MUN	CURRENCY_PAIR
CHFRWF=X	CHF/RWF	CCY	CURRENCY_PAIR
CADBGN=X	CAD/BGN	CCY	CURRENCY_PAIR
HRK=X	USD/HRK	CCY	CURRENCY_PAIR
CHFCNY=X	CHF/CNY	CCY	CURRENCY_PAIR
CHGLE.SW			CURRENCY_PAIR
CHFZWL=X	CHF/ZWL	CCY	CURRENCY_PAIR
RSM.PA			CURRENCY_PAIR
MYRGBP=X	MYR/GBP	CCY	CURRENCY_PAIR
COPJPY=X	COP/JPY	CCY	CURRENCY_PAIR
CADSOS=X	CAD/SOS	CCY	CURRENCY_PAIR
CNYLKR=X	CNY/LKR	CCY	CURRENCY_PAIR
CADJOD=X	CAD/JOD	CCY	CURRENCY_PAIR
EUR-ETB.F	EUR-ETB.F		CURRENCY_PAIR
CRC=X	USD/CRC	CCY	CURRENCY_PAIR
CZKAED=X	CZK/AED	CCY	CURRENCY_PAIR
CADILS=X	CAD/ILS	CCY	CURRENCY_PAIR
CADNGN=X	CAD/NGN	CCY	CURRENCY_PAIR
CZKPGK=X	CZK/PGK	CCY	CURRENCY_PAIR
CNYTHB=X	CNY/THB	CCY	CURRENCY_PAIR
CZKCOP=X	CZK/COP	CCY	CURRENCY_PAIR
EURGEL=X	EUR/GEL	CCY	CURRENCY_PAIR
CNYTND=X	CNY/TND	CCY	CURRENCY_PAIR
CHFGEL=X	CHF/GEL	CCY	CURRENCY_PAIR
CHFSBD=X	CHF/SBD	CCY	CURRENCY_PAIR
CHFNGN=X	CHF/NGN	CCY	CURRENCY_PAIR
CHFLBP=X	CHF/LBP	CCY	CURRENCY_PAIR
CADXOF=X	CAD/XOF	CCY	CURRENCY_PAIR
CADJMD=X	CAD/JMD	CCY	CURRENCY_PAIR
XCP=X	COPPER HIGHGRADE	CCY	CURRENCY_PAIR
COPCLP=X	COP/CLP	CCY	CURRENCY_PAIR
CADZWL=X	CAD/ZWL	CCY	CURRENCY_PAIR
COP=X	USD/COP	CCY	CURRENCY_PAIR
CHFGTQ=X	CHF/GTQ	CCY	CURRENCY_PAIR
CHFBHD=X	CHF/BHD	CCY	CURRENCY_PAIR
29134337=X			CURRENCY_PAIR
NZDNOK=X	NZD/NOK	CCY	CURRENCY_PAIR
29134335=X			CURRENCY_PAIR
CZKLBP=X	CZK/LBP	CCY	CURRENCY_PAIR
SEKNZD=X	SEK/NZD	CCY	CURRENCY_PAIR
CADETB=X	CAD/ETB	CCY	CURRENCY_PAIR
CADOMR=X	CAD/OMR	CCY	CURRENCY_PAIR
CNYMYR=X	CNY/MYR	CCY	CURRENCY_PAIR
CHFZMW=X	CHF/ZMW	CCY	CURRENCY_PAIR
CADLSL=X	CAD/LSL	CCY	CURRENCY_PAIR
CZKCAD=X	CZK/CAD	CCY	CURRENCY_PAIR
CADCZK=X	CAD/CZK	CCY	CURRENCY_PAIR
CZKNOK=X	CZK/NOK	CCY	CURRENCY_PAIR
CNHPHP=X	CNH/PHP	CCY	CURRENCY_PAIR
CNHHKD=X	CNH/HKD	CCY	CURRENCY_PAIR
CNYEGP=X	CNY/EGP	CCY	CURRENCY_PAIR
NZDZAR=X	NZD/ZAR	CCY	CURRENCY_PAIR
EUR-GIP.F	EUR-GIP.F		CURRENCY_PAIR
CZKOMR=X	CZK/OMR	CCY	CURRENCY_PAIR
CADSVC=X	CAD/SVC	CCY	CURRENCY_PAIR
CZKTWD=X	CZK/TWD	CCY	CURRENCY_PAIR
CADHUF=X	CAD/HUF	CCY	CURRENCY_PAIR
CADQAR=X	CAD/QAR	CCY	CURRENCY_PAIR
CADTHB=X	CAD/THB	CCY	CURRENCY_PAIR
CHFFKP=X	CHF/FKP	CCY	CURRENCY_PAIR
CLPPYG=X	CLP/PYG	CCY	CURRENCY_PAIR
SEKNOK=X	SEK/NOK	CCY	CURRENCY_PAIR
CHFCVE=X	CHF/CVE	CCY	CURRENCY_PAIR
CZKMXN=X	CZK/MXN	CCY	CURRENCY_PAIR
CADALL=X	CAD/ALL	CCY	CURRENCY_PAIR
CHFBGN=X	CHF/BGN	CCY	CURRENCY_PAIR
CADXPF=X	CAD/XPF	CCY	CURRENCY_PAIR
CADBHD=X	CAD/BHD	CCY	CURRENCY_PAIR
CLPTHB=X	CLP/THB	CCY	CURRENCY_PAIR
CHFITL=X	CHF/ITL	CCY	CURRENCY_PAIR
CLFUSD=X	CLF/USD	CCY	CURRENCY_PAIR
CNYOMR=X	CNY/OMR	CCY	CURRENCY_PAIR
CADBOB=X	CAD/BOB	CCY	CURRENCY_PAIR
CHFCZK=X	CHF/CZK	CCY	CURRENCY_PAIR
CHFPEN=X	CHF/PEN	CCY	CURRENCY_PAIR
CHFNIO=X	CHF/NIO	CCY	CURRENCY_PAIR
CADHTG=X	CAD/HTG	CCY	CURRENCY_PAIR
CHFCNH=X	CHF/CNH	CCY	CURRENCY_PAIR
CADGTQ=X	CAD/GTQ	CCY	CURRENCY_PAIR
CZKQAR=X	CZK/QAR	CCY	CURRENCY_PAIR
CADGMD=X	CAD/GMD	CCY	CURRENCY_PAIR
CADLYD=X	CAD/LYD	CCY	CURRENCY_PAIR
CADBWP=X	CAD/BWP	CCY	CURRENCY_PAIR
14243440.SW			CURRENCY_PAIR
HKDNOK=X	HKD/NOK	CCY	CURRENCY_PAIR
CHFSVC=X	CHF/SVC	CCY	CURRENCY_PAIR
CNYHKD=X	CNY/HKD	CCY	CURRENCY_PAIR
FSC1.EX			CURRENCY_PAIR
CADTOP=X	CAD/TOP	CCY	CURRENCY_PAIR
CADKGS=X	CAD/KGS	CCY	CURRENCY_PAIR
CHFUZS=X	CHF/UZS	CCY	CURRENCY_PAIR
CADVUV=X	CAD/VUV	CCY	CURRENCY_PAIR
CNYKWD=X	CNY/KWD	CCY	CURRENCY_PAIR
CADHRK=X	CAD/HRK	CCY	CURRENCY_PAIR
CZKPEN=X	CZK/PEN	CCY	CURRENCY_PAIR
CHFBOB=X	CHF/BOB	CCY	CURRENCY_PAIR
CHFTND=X	CHF/TND	CCY	CURRENCY_PAIR
CHOE.SW			CURRENCY_PAIR
CADKPW=X	CAD/KPW	CCY	CURRENCY_PAIR
SGDGBP=X	SGD/GBP	CCY	CURRENCY_PAIR
CHFLTL=X	CHF/LTL	CCY	CURRENCY_PAIR
CHFAUD=X	CHF/AUD	CCY	CURRENCY_PAIR
KESISK=X	KES/ISK	CCY	CURRENCY_PAIR
EUR-DZD.F	EUR-DZD.F	FRA	CURRENCY_PAIR
CLP=X	USD/CLP	CCY	CURRENCY_PAIR
CHFKZT=X	CHF/KZT	CCY	CURRENCY_PAIR
CADSTD=X	CAD/STD	CCY	CURRENCY_PAIR
CLFCLP=X	CLF/CLP	CCY	CURRENCY_PAIR
CADDKK=X	CAD/DKK	CCY	CURRENCY_PAIR
19664789.SW			CURRENCY_PAIR
29134336=X			CURRENCY_PAIR
CADDZD=X	CAD/DZD	CCY	CURRENCY_PAIR
CHFLVL=X	CHF/LVL	CCY	CURRENCY_PAIR
MYRNOK=X	MYR/NOK	CCY	CURRENCY_PAIR
CHFMAD=X	CHF/MAD	CCY	CURRENCY_PAIR
EURAFN=X	EUR/AFN	CCY	CURRENCY_PAIR
EURMNT=X	EUR/MNT	CCY	CURRENCY_PAIR
CLPVEF=X	CLP/VEF	CCY	CURRENCY_PAIR
CZKCHF=X	CZK/CHF	CCY	CURRENCY_PAIR
CZKLVL=X	CZK/LVL	CCY	CURRENCY_PAIR
CADXAF=X	CAD/XAF	CCY	CURRENCY_PAIR
CHFIQD=X	CHF/IQD	CCY	CURRENCY_PAIR
CADGHS=X	CAD/GHS	CCY	CURRENCY_PAIR
CADEGP=X	CAD/EGP	CCY	CURRENCY_PAIR
CYP=X	CYP=X	CCY	CURRENCY_PAIR
CADIQD=X	CAD/IQD	CCY	CURRENCY_PAIR
CVEUSD=X	CVE/USD	CCY	CURRENCY_PAIR
CVEDKK=X	CVE/DKK	CCY	CURRENCY_PAIR
CHFSEK=X	CHF/SEK	CCY	CURRENCY_PAIR
CHFHNL=X	CHF/HNL	CCY	CURRENCY_PAIR
19664658.SW	19664658.SW	EBS	CURRENCY_PAIR
CHFAOA=X	CHF/AOA	CCY	CURRENCY_PAIR
CNYSGD=X	CNY/SGD	CCY	CURRENCY_PAIR
CNYINR=X	CNY/INR	CCY	CURRENCY_PAIR
SGDNOK=X	SGD/NOK	CCY	CURRENCY_PAIR
CADTMT=X	CAD/TMT	CCY	CURRENCY_PAIR
CHFMNT=X	CHF/MNT	CCY	CURRENCY_PAIR
HKDGBP=X	HKD/GBP	CCY	CURRENCY_PAIR
CZKRON=X	CZK/RON	CCY	CURRENCY_PAIR
CHFYER=X	CHF/YER	CCY	CURRENCY_PAIR
CHFLAK=X	CHF/LAK	CCY	CURRENCY_PAIR
CHFGYD=X	CHF/GYD	CCY	CURRENCY_PAIR
CHTIE.SW	CHTIE.SW	EBS	CURRENCY_PAIR
CHFMWK=X	CHF/MWK	CCY	CURRENCY_PAIR
CADMNT=X	CAD/MNT	CCY	CURRENCY_PAIR
CADHKD=X	CAD/HKD	CCY	CURRENCY_PAIR
EURSLL=X	EUR/SLL	CCY	CURRENCY_PAIR
CADCVE=X	CAD/CVE	CCY	CURRENCY_PAIR
CZKDKK=X	CZK/DKK	CCY	CURRENCY_PAIR
CADSCR=X	CAD/SCR	CCY	CURRENCY_PAIR
CHFSCR=X	CHF/SCR	CCY	CURRENCY_PAIR
CHFKMF=X	CHF/KMF	CCY	CURRENCY_PAIR
CHFSAR=X	CHF/SAR	CCY	CURRENCY_PAIR
CHFHTG=X	CHF/HTG	CCY	CURRENCY_PAIR
CHFGMD=X	CHF/GMD	CCY	CURRENCY_PAIR
CZKPKR=X	CZK/PKR	CCY	CURRENCY_PAIR
CADNAD=X	CAD/NAD	CCY	CURRENCY_PAIR
CNYRUB=X	CNY/RUB	CCY	CURRENCY_PAIR
19666223.SW			CURRENCY_PAIR
CADCDF=X	CAD/CDF	CCY	CURRENCY_PAIR
CHFXDR=X	CHF/XDR	CCY	CURRENCY_PAIR
CLPUYU=X	CLP/UYU	CCY	CURRENCY_PAIR
CHFMYR=X	CHF/MYR	CCY	CURRENCY_PAIR
CLPBOB=X	CLP/BOB	CCY	CURRENCY_PAIR
29134334=X			CURRENCY_PAIR
CADLAK=X	CAD/LAK	CCY	CURRENCY_PAIR
CADHNL=X	CAD/HNL	CCY	CURRENCY_PAIR
CADBZD=X	CAD/BZD	CCY	CURRENCY_PAIR
CADINR=X	CAD/INR	CCY	CURRENCY_PAIR
EURGIP=X	EUR/GIP	CCY	CURRENCY_PAIR
CHFANG=X	CHF/ANG	CCY	CURRENCY_PAIR
CADKHR=X	CAD/KHR	CCY	CURRENCY_PAIR
SEKZAR=X	SEK/ZAR	CCY	CURRENCY_PAIR
CHFKWD=X	CHF/KWD	CCY	CURRENCY_PAIR
CADMXN=X	CAD/MXN	CCY	CURRENCY_PAIR
CHFSTD=X	CHF/STD	CCY	CURRENCY_PAIR
CHFSGD=X	CHF/SGD	CCY	CURRENCY_PAIR
CADSYP=X	CAD/SYP	CCY	CURRENCY_PAIR
CADXDR=X	CAD/XDR	CCY	CURRENCY_PAIR
CADGNF=X	CAD/GNF	CCY	CURRENCY_PAIR
20161078.SW	20161078.SW	EBS	CURRENCY_PAIR
CZKSAR=X	CZK/SAR	CCY	CURRENCY_PAIR
MYRSEK=X	MYR/SEK	CCY	CURRENCY_PAIR
CHFETB=X	CHF/ETB	CCY	CURRENCY_PAIR
EUR-SLL.F	EUR-SLL.F		CURRENCY_PAIR
CLPPEN=X	CLP/PEN	CCY	CURRENCY_PAIR
CADDJF=X	CAD/DJF	CCY	CURRENCY_PAIR
CHFCDF=X	CHF/CDF	CCY	CURRENCY_PAIR
22372096.SW			CURRENCY_PAIR
CADBAM=X	CAD/BAM	CCY	CURRENCY_PAIR
CNYISK=X	CNY/ISK	CCY	CURRENCY_PAIR
CHFQAR=X	CHF/QAR	CCY	CURRENCY_PAIR
CADAED=X	CAD/AED	CCY	CURRENCY_PAIR
EURETB=X	EUR/ETB	CCY	CURRENCY_PAIR
CLFGBP=X	CLF/GBP	CCY	CURRENCY_PAIR
CHFAED=X	CHF/AED	CCY	CURRENCY_PAIR
CHKOT.SW			CURRENCY_PAIR
CHFXCD=X	CHF/XCD	CCY	CURRENCY_PAIR
CADCOP=X	CAD/COP	CCY	CURRENCY_PAIR
CNHIDR=X	CNH/IDR	CCY	CURRENCY_PAIR
CHFTOP=X	CHF/TOP	CCY	CURRENCY_PAIR
CZKMUR=X	CZK/MUR	CCY	CURRENCY_PAIR
CHFTMT=X	CHF/TMT	CCY	CURRENCY_PAIR
CZKXDR=X	CZK/XDR	CCY	CURRENCY_PAIR
CNYCHF=X	CNY/CHF	CCY	CURRENCY_PAIR
NOKAUD=X	NOK/AUD	CCY	CURRENCY_PAIR
CHFLSL=X	CHF/LSL	CCY	CURRENCY_PAIR
CADPEN=X	CAD/PEN	CCY	CURRENCY_PAIR
22372094.SW	22372094.SW	EBS	CURRENCY_PAIR
CZKNGN=X	CZK/NGN	CCY	CURRENCY_PAIR
CHFBTN=X	CHF/BTN	CCY	CURRENCY_PAIR
CHDAV.SW			CURRENCY_PAIR
CHFBBD=X	CHF/BBD	CCY	CURRENCY_PAIR
CNYPLN=X	CNY/PLN	CCY	CURRENCY_PAIR
CHFMXN=X	CHF/MXN	CCY	CURRENCY_PAIR
CADSDG=X	CAD/SDG	CCY	CURRENCY_PAIR
CHFXPF=X	CHF/XPF	CCY	CURRENCY_PAIR
KESINR=X	KES/INR	CCY	CURRENCY_PAIR
CZKMAD=X	CZK/MAD	CCY	CURRENCY_PAIR
CADRON=X	CAD/RON	CCY	CURRENCY_PAIR
CHFTZS=X	CHF/TZS	CCY	CURRENCY_PAIR
CADBBD=X	CAD/BBD	CCY	CURRENCY_PAIR
CNHTHB=X	CNH/THB	CCY	CURRENCY_PAIR
CHFDKK=X	CHF/DKK	CCY	CURRENCY_PAIR
CNYQAR=X	CNY/QAR	CCY	CURRENCY_PAIR
CADBYR=X	CAD/BYR	CCY	CURRENCY_PAIR
CZKEGP=X	CZK/EGP	CCY	CURRENCY_PAIR
CZKCNY=X	CZK/CNY	CCY	CURRENCY_PAIR
CHFINR=X	CHF/INR	CCY	CURRENCY_PAIR
SEKAUD=X	SEK/AUD	CCY	CURRENCY_PAIR
CHFGIP=X	CHF/GIP	CCY	CURRENCY_PAIR
CADGEL=X	CAD/GEL	CCY	CURRENCY_PAIR
CZKBOB=X	CZK/BOB	CCY	CURRENCY_PAIR
CHFDOP=X	CHF/DOP	CCY	CURRENCY_PAIR
CHFMRO=X	CHF/MRO	CCY	CURRENCY_PAIR
CZKPLN=X	CZK/PLN	CCY	CURRENCY_PAIR
CZKCLP=X	CZK/CLP	CCY	CURRENCY_PAIR
CHFSDG=X	CHF/SDG	CCY	CURRENCY_PAIR
CADRWF=X	CAD/RWF	CCY	CURRENCY_PAIR
CHFPLN=X	CHF/PLN	CCY	CURRENCY_PAIR
CLPKRW=X	CLP/KRW	CCY	CURRENCY_PAIR
CHFIDR=X	CHF/IDR	CCY	CURRENCY_PAIR
CNYCZK=X	CNY/CZK	CCY	CURRENCY_PAIR
CHFAFN=X	CHF/AFN	CCY	CURRENCY_PAIR
19662920.SW	19662920.SW	EBS	CURRENCY_PAIR
CADDOP=X	CAD/DOP	CCY	CURRENCY_PAIR
CHFPKR=X	CHF/PKR	CCY	CURRENCY_PAIR
CHFSZL=X	CHF/SZL	CCY	CURRENCY_PAIR
CADCUP=X	CAD/CUP	CCY	CURRENCY_PAIR
CHFVUV=X	CHF/VUV	CCY	CURRENCY_PAIR
CADERN=X	CAD/ERN	CCY	CURRENCY_PAIR
CADZMK=X			CURRENCY_PAIR
CLPARS=X	CLP/ARS	CCY	CURRENCY_PAIR
COPUYU=X	COP/UYU	CCY	CURRENCY_PAIR
CZKUAH=X	CZK/UAH	CCY	CURRENCY_PAIR
CADIRR=X	CAD/IRR	CCY	CURRENCY_PAIR
CZKILS=X	CZK/ILS	CCY	CURRENCY_PAIR
CADMWK=X	CAD/MWK	CCY	CURRENCY_PAIR
CHFBSD=X	CHF/BSD	CCY	CURRENCY_PAIR
ZARANG=X	ZAR/ANG	CCY	CURRENCY_PAIR
CHFDJF=X	CHF/DJF	CCY	CURRENCY_PAIR
2218017=X			CURRENCY_PAIR
CADAUD=X	CAD/AUD	CCY	CURRENCY_PAIR
EUR-AFN.F	EUR-AFN.F	FRA	CURRENCY_PAIR
CADUYU=X	CAD/UYU	CCY	CURRENCY_PAIR
CADMAD=X	CAD/MAD	CCY	CURRENCY_PAIR
CNYHUF=X	CNY/HUF	CCY	CURRENCY_PAIR
CLPMXN=X	CLP/MXN	CCY	CURRENCY_PAIR
CZKRUB=X	CZK/RUB	CCY	CURRENCY_PAIR
EUR-DOP.F	EUR-DOP.F	FRA	CURRENCY_PAIR
CZKSEK=X	CZK/SEK	CCY	CURRENCY_PAIR
CADARS=X	CAD/ARS	CCY	CURRENCY_PAIR
CHFCOP=X	CHF/COP	CCY	CURRENCY_PAIR
CZKBMD=X	CZK/BMD	CCY	CURRENCY_PAIR
CNHJPY=X	CNH/JPY	CCY	CURRENCY_PAIR
CADCNH=X	CAD/CNH	CCY	CURRENCY_PAIR
CADPKR=X	CAD/PKR	CCY	CURRENCY_PAIR
COPPYG=X	COP/PYG	CCY	CURRENCY_PAIR
DOPGBP=X	DOP/GBP	CCY	CURRENCY_PAIR
DOPEUR=X	DOP/EUR	CCY	CURRENCY_PAIR
DKKTWD=X	DKK/TWD	CCY	CURRENCY_PAIR
DKKTND=X	DKK/TND	CCY	CURRENCY_PAIR
DKKSAR=X	DKK/SAR	CCY	CURRENCY_PAIR
DKKMYR=X	DKK/MYR	CCY	CURRENCY_PAIR
DKKJPY=X	DKK/JPY	CCY	CURRENCY_PAIR
DKKHUF=X	DKK/HUF	CCY	CURRENCY_PAIR
DKKCLP=X	DKK/CLP	CCY	CURRENCY_PAIR
DKKCHF=X	DKK/CHF	CCY	CURRENCY_PAIR
DEM=X	USD/DEM	CCY	CURRENCY_PAIR
DKKQAR=X	DKK/QAR	CCY	CURRENCY_PAIR
DKKBAM=X	DKK/BAM	CCY	CURRENCY_PAIR
DKKCZK=X	DKK/CZK	CCY	CURRENCY_PAIR
DKKSGD=X	DKK/SGD	CCY	CURRENCY_PAIR
DKKINR=X	DKK/INR	CCY	CURRENCY_PAIR
DKKJOD=X	DKK/JOD	CCY	CURRENCY_PAIR
PLNSEK=X	PLN/SEK	CCY	CURRENCY_PAIR
DKKTRY=X	DKK/TRY	CCY	CURRENCY_PAIR
DZDUSD=X	DZD/USD	CCY	CURRENCY_PAIR
DKKRON=X	DKK/RON	CCY	CURRENCY_PAIR
DKKKWD=X	DKK/KWD	CCY	CURRENCY_PAIR
DKKPHP=X	DKK/PHP	CCY	CURRENCY_PAIR
DWHEAT.MDD	DWHEAT.MDD	MDD	CURRENCY_PAIR
DKKHKD=X	DKK/HKD	CCY	CURRENCY_PAIR
29134338=X			CURRENCY_PAIR
DKKKRW=X	DKK/KRW	CCY	CURRENCY_PAIR
DKKMXN=X	DKK/MXN	CCY	CURRENCY_PAIR
DEMCHF=X	DEM/CHF	CCY	CURRENCY_PAIR
DKKGIP=X	DKK/GIP	CCY	CURRENCY_PAIR
DJFCHF=X	DJF/CHF	CCY	CURRENCY_PAIR
DKKBRL=X	DKK/BRL	CCY	CURRENCY_PAIR
DOPUSD=X	DOP/USD	CCY	CURRENCY_PAIR
DOPDKK=X	DOP/DKK	CCY	CURRENCY_PAIR
DKKOMR=X	DKK/OMR	CCY	CURRENCY_PAIR
DKKMUR=X	DKK/MUR	CCY	CURRENCY_PAIR
DZDGBP=X	DZD/GBP	CCY	CURRENCY_PAIR
DKKPKR=X	DKK/PKR	CCY	CURRENCY_PAIR
DJFUSD=X	DJF/USD	CCY	CURRENCY_PAIR
DKKIDR=X	DKK/IDR	CCY	CURRENCY_PAIR
DKKRSD=X	DKK/RSD	CCY	CURRENCY_PAIR
DKK=X	USD/DKK	CCY	CURRENCY_PAIR
DOPCHF=X	DOP/CHF	CCY	CURRENCY_PAIR
DKKAED=X	DKK/AED	CCY	CURRENCY_PAIR
DKKUAH=X	DKK/UAH	CCY	CURRENCY_PAIR
DKKTHB=X	DKK/THB	CCY	CURRENCY_PAIR
DKKLVL=X	DKK/LVL	CCY	CURRENCY_PAIR
DKKLTL=X	DKK/LTL	CCY	CURRENCY_PAIR
DKKAUD=X	DKK/AUD	CCY	CURRENCY_PAIR
MKDDKK=X	MKD/DKK	CCY	CURRENCY_PAIR
DKKPLN=X	DKK/PLN	CCY	CURRENCY_PAIR
DJF=X	USD/DJF	CCY	CURRENCY_PAIR
DKKSEK=X	DKK/SEK	CCY	CURRENCY_PAIR
DKKCAD=X	DKK/CAD	CCY	CURRENCY_PAIR
DZDMAD=X	DZD/MAD	CCY	CURRENCY_PAIR
DKKKPW=X	DKK/KPW	CCY	CURRENCY_PAIR
DZDEUR=X	DZD/EUR	CCY	CURRENCY_PAIR
DKKBGN=X	DKK/BGN	CCY	CURRENCY_PAIR
DKKNOK=X	DKK/NOK	CCY	CURRENCY_PAIR
DKKEUR=X	DKK/EUR	CCY	CURRENCY_PAIR
DKKXDR=X	DKK/XDR	CCY	CURRENCY_PAIR
DKKLKR=X	DKK/LKR	CCY	CURRENCY_PAIR
DJFEUR=X	DJF/EUR	CCY	CURRENCY_PAIR
DKKUSD=X	DKK/USD	CCY	CURRENCY_PAIR
DKKANG=X	DKK/ANG	CCY	CURRENCY_PAIR
DKKGBP=X	DKK/GBP	CCY	CURRENCY_PAIR
DKKNZD=X	DKK/NZD	CCY	CURRENCY_PAIR
DKKRUB=X	DKK/RUB	CCY	CURRENCY_PAIR
DKKISK=X	DKK/ISK	CCY	CURRENCY_PAIR
DKKILS=X	DKK/ILS	CCY	CURRENCY_PAIR
DZD=X	USD/DZD	CCY	CURRENCY_PAIR
DOP=X	USD/DOP	CCY	CURRENCY_PAIR
DKKKES=X	DKK/KES	CCY	CURRENCY_PAIR
DKKZAR=X	DKK/ZAR	CCY	CURRENCY_PAIR
DKKCNY=X	DKK/CNY	CCY	CURRENCY_PAIR
DKKEGP=X	DKK/EGP	CCY	CURRENCY_PAIR
DKKMAD=X	DKK/MAD	CCY	CURRENCY_PAIR
EURUSD=X	EUR/USD	CCY	CURRENCY_PAIR
EURGBP=X	EUR/GBP	CCY	CURRENCY_PAIR
EURJPY=X	EUR/JPY	CCY	CURRENCY_PAIR
EURCHF=X	EUR/CHF	CCY	CURRENCY_PAIR
EURSYP=X	EUR/SYP	CCY	CURRENCY_PAIR
EURSOS=X	EUR/SOS	CCY	CURRENCY_PAIR
EURAUD=X	EUR/AUD	CCY	CURRENCY_PAIR
ECS=X	USD/ECS	CCY	CURRENCY_PAIR
EURYER=X	EUR/YER	CCY	CURRENCY_PAIR
EURVND=X	EUR/VND	CCY	CURRENCY_PAIR
EURUSDFIX=X			CURRENCY_PAIR
EURUGX=X	EUR/UGX	CCY	CURRENCY_PAIR
EURSBD=X	EUR/SBD	CCY	CURRENCY_PAIR
EURRSD=X	EUR/RSD	CCY	CURRENCY_PAIR
EURPLN=X	EUR/PLN	CCY	CURRENCY_PAIR
EURPAB=X	EUR/PAB	CCY	CURRENCY_PAIR
EURNZD=X	EUR/NZD	CCY	CURRENCY_PAIR
EURNPR=X	EUR/NPR	CCY	CURRENCY_PAIR
EURMYR=X	EUR/MYR	CCY	CURRENCY_PAIR
EURMWK=X	EUR/MWK	CCY	CURRENCY_PAIR
EURMVR=X	EUR/MVR	CCY	CURRENCY_PAIR
EURMRO=X	EUR/MRO	CCY	CURRENCY_PAIR
EURMDL=X	EUR/MDL	CCY	CURRENCY_PAIR
EURLKR=X	EUR/LKR	CCY	CURRENCY_PAIR
EURLAK=X	EUR/LAK	CCY	CURRENCY_PAIR
EURCZK=X	EUR/CZK	CCY	CURRENCY_PAIR
EUR=X	USD/EUR	CCY	CURRENCY_PAIR
EGPZAR=X	EGP/ZAR	CCY	CURRENCY_PAIR
EGPTRY=X	EGP/TRY	CCY	CURRENCY_PAIR
EGPMXN=X	EGP/MXN	CCY	CURRENCY_PAIR
EGPKRW=X	EGP/KRW	CCY	CURRENCY_PAIR
EGPILS=X	EGP/ILS	CCY	CURRENCY_PAIR
EGPHUF=X	EGP/HUF	CCY	CURRENCY_PAIR
EURBSD=X	EUR/BSD	CCY	CURRENCY_PAIR
EURISK=X	EUR/ISK	CCY	CURRENCY_PAIR
EURZAR=X	EUR/ZAR	CCY	CURRENCY_PAIR
EGPINR=X	EGP/INR	CCY	CURRENCY_PAIR
EURCADFIX=X			CURRENCY_PAIR
EUR-GBP.F	EUR-GBP.F	FRA	CURRENCY_PAIR
EUR-MWK.F	EUR-MWK.F		CURRENCY_PAIR
EUR-SVC.F	EUR-SVC.F	FRA	CURRENCY_PAIR
EURMKD=X	EUR/MKD	CCY	CURRENCY_PAIR
EURBAM=X	EUR/BAM	CCY	CURRENCY_PAIR
EURBGN=X	EUR/BGN	CCY	CURRENCY_PAIR
EUR-HUF.F	EUR-HUF.F		CURRENCY_PAIR
EURPKR=X	EUR/PKR	CCY	CURRENCY_PAIR
EUR-LVL.F	EUR-LVL.F		CURRENCY_PAIR
EURKRW=X	EUR/KRW	CCY	CURRENCY_PAIR
429714=X			CURRENCY_PAIR
EURAOA=X	EUR/AOA	CCY	CURRENCY_PAIR
EUR-TTD.F	EUR-TTD.F		CURRENCY_PAIR
ETBCHF=X	ETB/CHF	CCY	CURRENCY_PAIR
EURSVC=X	EUR/SVC	CCY	CURRENCY_PAIR
EGPJPY=X	EGP/JPY	CCY	CURRENCY_PAIR
XF000EURTRY6.SG			CURRENCY_PAIR
EURCRC=X	EUR/CRC	CCY	CURRENCY_PAIR
EUR-UZS.F	EUR-UZS.F	FRA	CURRENCY_PAIR
EUR-HTG.F	EUR-HTG.F	FRA	CURRENCY_PAIR
XF000EURCHF2.SG	XF000EURCHF2.SG	STU	CURRENCY_PAIR
EURAED=X	EUR/AED	CCY	CURRENCY_PAIR
XF000EURINR2.SG			CURRENCY_PAIR
EURBIF=X	EUR/BIF	CCY	CURRENCY_PAIR
XF000EURDKK4.SG			CURRENCY_PAIR
EUR-MMK.F	EUR-MMK.F		CURRENCY_PAIR
EURLVL=X	EUR/LVL	CCY	CURRENCY_PAIR
EGPNZD=X	EGP/NZD	CCY	CURRENCY_PAIR
EUR-OMR.F	EUR-OMR.F	FRA	CURRENCY_PAIR
EUR-PHP.F	EUR-PHP.F	FRA	CURRENCY_PAIR
EURGTQ=X	EUR/GTQ	CCY	CURRENCY_PAIR
EGPGBP=X	EGP/GBP	CCY	CURRENCY_PAIR
EGPAED=X	EGP/AED	CCY	CURRENCY_PAIR
EUR-CNY.F	EUR-CNY.F		CURRENCY_PAIR
EUR-EGP.F	EUR-EGP.F	FRA	CURRENCY_PAIR
EURJPYFIX=X			CURRENCY_PAIR
EURALL=X	EUR/ALL	CCY	CURRENCY_PAIR
EUR-MAD.F	EUR-MAD.F		CURRENCY_PAIR
EURCAD=X	EUR/CAD	CCY	CURRENCY_PAIR
EURCYP=X	EUR/CYP	CCY	CURRENCY_PAIR
EURPYG=X	EUR/PYG	CCY	CURRENCY_PAIR
EGPAUD=X	EGP/AUD	CCY	CURRENCY_PAIR
EUR-YER.F	EUR-YER.F	FRA	CURRENCY_PAIR
EUR-HNL.F	EUR-HNL.F		CURRENCY_PAIR
EGPNOK=X	EGP/NOK	CCY	CURRENCY_PAIR
EURTOP=X	EUR/TOP	CCY	CURRENCY_PAIR
EGPKWD=X	EGP/KWD	CCY	CURRENCY_PAIR
EUR-PGK.F	EUR-PGK.F		CURRENCY_PAIR
EURAMD=X	EUR/AMD	CCY	CURRENCY_PAIR
EURNOKFIX=X			CURRENCY_PAIR
EUR-MGA.F	EUR-MGA.F		CURRENCY_PAIR
EURXPF=X	EUR/XPF	CCY	CURRENCY_PAIR
EURZMW=X	EUR/ZMW	CCY	CURRENCY_PAIR
ETB=X	USD/ETB	CCY	CURRENCY_PAIR
EGPSGD=X	EGP/SGD	CCY	CURRENCY_PAIR
EUR-SDG.F	EUR-SDG.F	FRA	CURRENCY_PAIR
EGPUSD=X	EGP/USD	CCY	CURRENCY_PAIR
ERN=X	USD/ERN	CCY	CURRENCY_PAIR
EGPKES=X	EGP/KES	CCY	CURRENCY_PAIR
EUR-NPR.F	EUR-NPR.F	FRA	CURRENCY_PAIR
EURCUP=X	EUR/CUP	CCY	CURRENCY_PAIR
EURNAD=X	EUR/NAD	CCY	CURRENCY_PAIR
EURSAR=X	EUR/SAR	CCY	CURRENCY_PAIR
EGPMAD=X	EGP/MAD	CCY	CURRENCY_PAIR
EUREGP=X	EUR/EGP	CCY	CURRENCY_PAIR
EURMMK=X	EUR/MMK	CCY	CURRENCY_PAIR
EUR-GYD.F	EUR-GYD.F	FRA	CURRENCY_PAIR
985793=X			CURRENCY_PAIR
EUR-BHD.F	EUR-BHD.F		CURRENCY_PAIR
XF000EURHKD0.SG			CURRENCY_PAIR
EUR-SZL.F	EUR-SZL.F	FRA	CURRENCY_PAIR
EUR-KRW.F	EUR-KRW.F		CURRENCY_PAIR
EGPQAR=X	EGP/QAR	CCY	CURRENCY_PAIR
EUR-CUP.F	EUR-CUP.F		CURRENCY_PAIR
EURTHB=X	EUR/THB	CCY	CURRENCY_PAIR
EURHTG=X	EUR/HTG	CCY	CURRENCY_PAIR
EURCHFFIX=X			CURRENCY_PAIR
EUR-VND.F	EUR-VND.F		CURRENCY_PAIR
EUR-ISK.F	EUR-ISK.F		CURRENCY_PAIR
EURARS=X	EUR/ARS	CCY	CURRENCY_PAIR
EURKMF=X	EUR/KMF	CCY	CURRENCY_PAIR
EUR-SYP.F	EUR-SYP.F		CURRENCY_PAIR
EGPEUR=X	EGP/EUR	CCY	CURRENCY_PAIR
EUR-CHF.F	EUR-CHF.F	FRA	CURRENCY_PAIR
EURZWL=X	EUR/ZWL	CCY	CURRENCY_PAIR
EURDJF=X	EUR/DJF	CCY	CURRENCY_PAIR
EUR-SCR.F	EUR-SCR.F		CURRENCY_PAIR
EUR-DKK.F	EUR-DKK.F		CURRENCY_PAIR
EGPSAR=X	EGP/SAR	CCY	CURRENCY_PAIR
EGPJOD=X	EGP/JOD	CCY	CURRENCY_PAIR
EURFKP=X	EUR/FKP	CCY	CURRENCY_PAIR
EURMAD=X	EUR/MAD	CCY	CURRENCY_PAIR
EURLRD=X	EUR/LRD	CCY	CURRENCY_PAIR
EUR-GMD.F	EUR-GMD.F	FRA	CURRENCY_PAIR
EUR-ZAR.F	EUR-ZAR.F		CURRENCY_PAIR
EUR-QAR.F	EUR-QAR.F	FRA	CURRENCY_PAIR
XF000EURNOK5.SG			CURRENCY_PAIR
EONK.F	EONK.F		CURRENCY_PAIR
EGPPKR=X	EGP/PKR	CCY	CURRENCY_PAIR
XF000EURBRL1.SG	XF000EURBRL1.SG	STU	CURRENCY_PAIR
EURDKK=X	EUR/DKK	CCY	CURRENCY_PAIR
EURIQD=X	EUR/IQD	CCY	CURRENCY_PAIR
OCEU.EX			CURRENCY_PAIR
EUR-HKD.F	EUR-HKD.F	FRA	CURRENCY_PAIR
XF000EURHUF4.SG	XF000EURHUF4.SG	STU	CURRENCY_PAIR
EUR-AOA.F	EUR-AOA.F	FRA	CURRENCY_PAIR
EGPLKR=X	EGP/LKR	CCY	CURRENCY_PAIR
EURAZN=X	EUR/AZN	CCY	CURRENCY_PAIR
EURGYD=X	EUR/GYD	CCY	CURRENCY_PAIR
EGPOMR=X	EGP/OMR	CCY	CURRENCY_PAIR
EURSEKFIX=X			CURRENCY_PAIR
EURMOP=X	EUR/MOP	CCY	CURRENCY_PAIR
EUR-SOS.F	EUR-SOS.F	FRA	CURRENCY_PAIR
EUR-XDR.F	EUR-XDR.F		CURRENCY_PAIR
EGPRUB=X	EGP/RUB	CCY	CURRENCY_PAIR
EGPLVL=X	EGP/LVL	CCY	CURRENCY_PAIR
EUR-CZK.F	EUR-CZK.F		CURRENCY_PAIR
EUR-MOP.F	EUR-MOP.F		CURRENCY_PAIR
EGPHKD=X	EGP/HKD	CCY	CURRENCY_PAIR
EUR-XCD.F	EUR-XCD.F	FRA	CURRENCY_PAIR
EOYN.F	EOYN.F		CURRENCY_PAIR
EURKHR=X	EUR/KHR	CCY	CURRENCY_PAIR
881349.MC			CURRENCY_PAIR
EURSEK=X	EUR/SEK	CCY	CURRENCY_PAIR
EURAWG=X	EUR/AWG	CCY	CURRENCY_PAIR
EUR-LRD.F	EUR-LRD.F		CURRENCY_PAIR
IDEPM.MDD	IDEPM.MDD	MDD	CURRENCY_PAIR
EUR-IRR.F	EUR-IRR.F		CURRENCY_PAIR
EUR-GTQ.F	EUR-GTQ.F		CURRENCY_PAIR
EUR-PYG.F	EUR-PYG.F		CURRENCY_PAIR
EURTZS=X	EUR/TZS	CCY	CURRENCY_PAIR
EUR-CNH.F	EUR-CNH.F	FRA	CURRENCY_PAIR
EURBYR=X	EUR/BYR	CCY	CURRENCY_PAIR
EUROMR=X	EUR/OMR	CCY	CURRENCY_PAIR
XF000EURCNY1.SG			CURRENCY_PAIR
EURBRL=X	EUR/BRL	CCY	CURRENCY_PAIR
EURIRR=X	EUR/IRR	CCY	CURRENCY_PAIR
EGPSEK=X	EGP/SEK	CCY	CURRENCY_PAIR
EURKYD=X	EUR/KYD	CCY	CURRENCY_PAIR
EURANG=X	EUR/ANG	CCY	CURRENCY_PAIR
EURGNF=X	EUR/GNF	CCY	CURRENCY_PAIR
EUR-RON.F	EUR-RON.F		CURRENCY_PAIR
EUR-KHR.F	EUR-KHR.F	FRA	CURRENCY_PAIR
EURPGK=X	EUR/PGK	CCY	CURRENCY_PAIR
EURNGN=X	EUR/NGN	CCY	CURRENCY_PAIR
XF000EURSEK5.SG	XF000EURSEK5.SG	STU	CURRENCY_PAIR
EUR-GNF.F	EUR-GNF.F		CURRENCY_PAIR
EUR-DJF.F	EUR-DJF.F	FRA	CURRENCY_PAIR
EURTWD=X	EUR/TWD	CCY	CURRENCY_PAIR
EUR-KYD.F	EUR-KYD.F	FRA	CURRENCY_PAIR
EUR-MRO.F	EUR/MRO	FRA	CURRENCY_PAIR
EURQAR=X	EUR/QAR	CCY	CURRENCY_PAIR
EUR-BAM.F	EUR-BAM.F	FRA	CURRENCY_PAIR
EURVEF=X	EUR/VEF	CCY	CURRENCY_PAIR
ERNUSD=X	ERN/USD	CCY	CURRENCY_PAIR
EURRUB=X	EUR/RUB	CCY	CURRENCY_PAIR
EUR-BBD.F	EUR-BBD.F		CURRENCY_PAIR
EURFJD=X	EUR/FJD	CCY	CURRENCY_PAIR
XF000EURGBP5.SG	XF000EURGBP5.SG	STU	CURRENCY_PAIR
FCEP.EX			CURRENCY_PAIR
EOCD.F	EOCD.F		CURRENCY_PAIR
EUR-LYD.F	EUR-LYD.F		CURRENCY_PAIR
OCEF.EX			CURRENCY_PAIR
EURKGS=X	EUR/KGS	CCY	CURRENCY_PAIR
EUR-ARS.F	EUR-ARS.F	FRA	CURRENCY_PAIR
EURLSL=X	EUR/LSL	CCY	CURRENCY_PAIR
EURDKKFIX=X			CURRENCY_PAIR
EURUZS=X	EUR/UZS	CCY	CURRENCY_PAIR
EURSDG=X	EUR/SDG	CCY	CURRENCY_PAIR
EUR-NAD.F	EUR-NAD.F	FRA	CURRENCY_PAIR
EURVUV=X	EUR/VUV	CCY	CURRENCY_PAIR
EUR-JMD.F	EUR-JMD.F		CURRENCY_PAIR
EUR-SAR.F	EUR-SAR.F	FRA	CURRENCY_PAIR
EUR-NZD.F	EUR-NZD.F	FRA	CURRENCY_PAIR
EURBBD=X	EUR/BBD	CCY	CURRENCY_PAIR
EURBHD=X	EUR/BHD	CCY	CURRENCY_PAIR
EUR-CDF.F	EUR-CDF.F		CURRENCY_PAIR
EUR-TMM.F	EUR-TMM.F	FRA	CURRENCY_PAIR
EUR-BRL.F	EUR-BRL.F		CURRENCY_PAIR
EURTTD=X	EUR/TTD	CCY	CURRENCY_PAIR
EUR-TMT.F	EUR-TMT.F		CURRENCY_PAIR
EURCDF=X	EUR/CDF	CCY	CURRENCY_PAIR
EURPHP=X	EUR/PHP	CCY	CURRENCY_PAIR
EURSZL=X	EUR/SZL	CCY	CURRENCY_PAIR
EURLTL=X	EUR/LTL	CCY	CURRENCY_PAIR
GDEPY.MDD			CURRENCY_PAIR
EUR-INR.F	EUR-INR.F		CURRENCY_PAIR
IDEPQ.MDD			CURRENCY_PAIR
EUR-JPY.F	EUR-JPY.F	FRA	CURRENCY_PAIR
XF000EURIDR3.SG	XF000EURIDR3.SG	STU	CURRENCY_PAIR
EURUAH=X	EUR/UAH	CCY	CURRENCY_PAIR
XF000EURCZK4.SG	XF000EURCZK4.SG	STU	CURRENCY_PAIR
EURBTN=X	EUR/BTN	CCY	CURRENCY_PAIR
EUR-CAD.F	EUR-CAD.F		CURRENCY_PAIR
2108862=X			CURRENCY_PAIR
EUR-WST.F	EUR-WST.F	FRA	CURRENCY_PAIR
XF000EURCLP3.SG			CURRENCY_PAIR
ETBGBP=X	ETB/GBP	CCY	CURRENCY_PAIR
EURJMD=X	EUR/JMD	CCY	CURRENCY_PAIR
XF000EURZAR3.SG			CURRENCY_PAIR
EURKPW=X	EUR/KPW	CCY	CURRENCY_PAIR
EUR-PLN.F	EUR-PLN.F	FRA	CURRENCY_PAIR
EURGBPFIX=X			CURRENCY_PAIR
EUR-AUD.F	EUR-AUD.F		CURRENCY_PAIR
EUR-ZMW.F	EUR-ZMW.F		CURRENCY_PAIR
EUR-BGN.F	EUR-BGN.F		CURRENCY_PAIR
EURXOF=X	EUR/XOF	CCY	CURRENCY_PAIR
EUR-BND.F	EUR-BND.F		CURRENCY_PAIR
EDX.PA			CURRENCY_PAIR
EUR-STD.F	EUR-STD.F	FRA	CURRENCY_PAIR
EGPPLN=X	EGP/PLN	CCY	CURRENCY_PAIR
EUR-UAH.F	EUR-UAH.F		CURRENCY_PAIR
ETBUSD=X	ETB/USD	CCY	CURRENCY_PAIR
EUR-KGS.F	EUR-KGS.F	FRA	CURRENCY_PAIR
EURCNH=X	EUR/CNH	CCY	CURRENCY_PAIR
EUR-SGD.F	EUR-SGD.F		CURRENCY_PAIR
EURXDR=X	EUR/XDR	CCY	CURRENCY_PAIR
EUREUR=X	EUR/EUR	CCY	CURRENCY_PAIR
EURTJS=X	EUR/TJS	CCY	CURRENCY_PAIR
EUR-EEK.F	EUR-EEK.F	FRA	CURRENCY_PAIR
EUR-IDR.F	EUR-IDR.F		CURRENCY_PAIR
EURTND=X	EUR/TND	CCY	CURRENCY_PAIR
EURLTL-FIX=X			CURRENCY_PAIR
EUR-MVR.F	EUR-MVR.F	FRA	CURRENCY_PAIR
EOLS.F	EOLS.F		CURRENCY_PAIR
EURRWF=X	EUR/RWF	CCY	CURRENCY_PAIR
EURMZN=X	EUR/MZN	CCY	CURRENCY_PAIR
EURKWD=X	EUR/KWD	CCY	CURRENCY_PAIR
ERNEUR=X	ERN/EUR	CCY	CURRENCY_PAIR
EUR-RUB.F	EUR-RUB.F	FRA	CURRENCY_PAIR
EURUSDCB.ME			CURRENCY_PAIR
EUR-TWD.F	EUR-TWD.F		CURRENCY_PAIR
XF000EURSGD5.SG			CURRENCY_PAIR
EUR-LAK.F	EUR-LAK.F		CURRENCY_PAIR
XF000EURJPY1.SG			CURRENCY_PAIR
XF000EURUSD6.SG			CURRENCY_PAIR
EURSRD=X	EUR/SRD	CCY	CURRENCY_PAIR
EURNOK=X	EUR/NOK	CCY	CURRENCY_PAIR
EGPTND=X	EGP/TND	CCY	CURRENCY_PAIR
EGPLTL=X	EGP/LTL	CCY	CURRENCY_PAIR
EURSHP=X	EUR/SHP	CCY	CURRENCY_PAIR
EURBND=X	EUR/BND	CCY	CURRENCY_PAIR
EURSCR=X	EUR/SCR	CCY	CURRENCY_PAIR
EURNIO=X	EUR/NIO	CCY	CURRENCY_PAIR
EUR-RSD.F	EUR-RSD.F	FRA	CURRENCY_PAIR
EUR-KWD.F	EUR-KWD.F	FRA	CURRENCY_PAIR
EURGMD=X	EUR/GMD	CCY	CURRENCY_PAIR
EUR-CRC.F	EUR-CRC.F		CURRENCY_PAIR
EUR-CVE.F	EUR-CVE.F	FRA	CURRENCY_PAIR
EURWST=X	EUR/WST	CCY	CURRENCY_PAIR
EBM.PA			CURRENCY_PAIR
EUR-LSL.F	EUR-LSL.F		CURRENCY_PAIR
EGP=X	USD/EGP	CCY	CURRENCY_PAIR
EUR-LKR.F	EUR-LKR.F	FRA	CURRENCY_PAIR
EUR-USD.F	EUR-USD.F		CURRENCY_PAIR
EUR-PAB.F	EUR-PAB.F	FRA	CURRENCY_PAIR
EURHKD=X	EUR/HKD	CCY	CURRENCY_PAIR
EGPMUR=X	EGP/MUR	CCY	CURRENCY_PAIR
EURSGD=X	EUR/SGD	CCY	CURRENCY_PAIR
EURCNY=X	EUR/CNY	CCY	CURRENCY_PAIR
EUR-XPF.F	EUR-XPF.F		CURRENCY_PAIR
EUR-XOF.F	EUR-XOF.F		CURRENCY_PAIR
EUR-BIF.F	EUR-BIF.F		CURRENCY_PAIR
EGPTHB=X	EGP/THB	CCY	CURRENCY_PAIR
XF000EURMXN2.SG			CURRENCY_PAIR
ETBEUR=X	ETB/EUR	CCY	CURRENCY_PAIR
EUR-BYR.F	EUR-BYR.F		CURRENCY_PAIR
EUR-NOK.F	EUR-NOK.F		CURRENCY_PAIR
EGPCZK=X	EGP/CZK	CCY	CURRENCY_PAIR
EUR-AZN.F	EUR-AZN.F		CURRENCY_PAIR
EURIDR=X	EUR/IDR	CCY	CURRENCY_PAIR
EUR-PKR.F	EUR-PKR.F		CURRENCY_PAIR
EUR-VEF.F	EUR-VEF.F		CURRENCY_PAIR
EURMXN=X	EUR/MXN	CCY	CURRENCY_PAIR
EURRON=X	EUR/RON	CCY	CURRENCY_PAIR
EUR-MXN.F	EUR-MXN.F	FRA	CURRENCY_PAIR
XF000EURCAD2.SG			CURRENCY_PAIR
EURHNL=X	EUR/HNL	CCY	CURRENCY_PAIR
EUR-TND.F	EUR-TND.F		CURRENCY_PAIR
EUR-EUR.F	EUR-EUR.F		CURRENCY_PAIR
EUR-IQD.F	EUR-IQD.F		CURRENCY_PAIR
XF000EURPLN0.SG			CURRENCY_PAIR
EUR-ANG.F	EUR-ANG.F		CURRENCY_PAIR
EUR-FJD.F	EUR-FJD.F	FRA	CURRENCY_PAIR
EGPCAD=X	EGP/CAD	CCY	CURRENCY_PAIR
EURGHS=X	EUR/GHS	CCY	CURRENCY_PAIR
EURMGA=X	EUR/MGA	CCY	CURRENCY_PAIR
XF000EURNZD6.SG			CURRENCY_PAIR
EUR-MKD.F	EUR-MKD.F		CURRENCY_PAIR
EURERN=X	EUR/ERN	CCY	CURRENCY_PAIR
GDEPQ.MDD			CURRENCY_PAIR
EUR-CLP.F	EUR-CLP.F	FRA	CURRENCY_PAIR
EOSF.F	EOSF.F		CURRENCY_PAIR
EURCVE=X	EUR/CVE	CCY	CURRENCY_PAIR
EURSTD=X	EUR/STD	CCY	CURRENCY_PAIR
EUR-UGX.F	EUR-UGX.F		CURRENCY_PAIR
EGPPHP=X	EGP/PHP	CCY	CURRENCY_PAIR
EUR-AED.F	EUR-AED.F		CURRENCY_PAIR
EUR-THB.F	EUR-THB.F		CURRENCY_PAIR
EGPDKK=X	EGP/DKK	CCY	CURRENCY_PAIR
XF000EURAUD4.SG			CURRENCY_PAIR
EUR-BSD.F	EUR-BSD.F		CURRENCY_PAIR
EUR-RWF.F	EUR-RWF.F	FRA	CURRENCY_PAIR
EUR-MZN.F	EUR-MZN.F		CURRENCY_PAIR
EUR-SEK.F	EUR-SEK.F		CURRENCY_PAIR
EUR-AMD.F	EUR-AMD.F	FRA	CURRENCY_PAIR
EURINR=X	EUR/INR	CCY	CURRENCY_PAIR
EUR-GHS.F	EUR-GHS.F	FRA	CURRENCY_PAIR
EUR-TZS.F	EUR-TZS.F		CURRENCY_PAIR
GDEPM.MDD	GDEPM.MDD	MDD	CURRENCY_PAIR
XF000EURRUB2.SG			CURRENCY_PAIR
EUR-LTL.F	EUR-LTL.F	FRA	CURRENCY_PAIR
EURHUF=X	EUR/HUF	CCY	CURRENCY_PAIR
EUR-MDL.F	EUR-MDL.F		CURRENCY_PAIR
EODL.F	EODL.F	FRA	CURRENCY_PAIR
EUR-NIO.F	EUR-NIO.F		CURRENCY_PAIR
EUR-MYR.F	EUR-MYR.F	FRA	CURRENCY_PAIR
EURCLP=X	EUR/CLP	CCY	CURRENCY_PAIR
EGPCNY=X	EGP/CNY	CCY	CURRENCY_PAIR
EUR-SRD.F	EUR-SRD.F		CURRENCY_PAIR
EURCLF=X	EUR/CLF	CCY	CURRENCY_PAIR
EUR-ALL.F	EUR-ALL.F	FRA	CURRENCY_PAIR
EGPIDR=X	EGP/IDR	CCY	CURRENCY_PAIR
IDEPY.MDD			CURRENCY_PAIR
EODK.F	EODK.F		CURRENCY_PAIR
EURLYD=X	EUR/LYD	CCY	CURRENCY_PAIR
EUR-NGN.F	EUR-NGN.F		CURRENCY_PAIR
EURTMT=X	EUR/TMT	CCY	CURRENCY_PAIR
EOSK.F	EOSK.F	FRA	CURRENCY_PAIR
EURXCD=X	EUR/XCD	CCY	CURRENCY_PAIR
EGPCHF=X	EGP/CHF	CCY	CURRENCY_PAIR
EGPTWD=X	EGP/TWD	CCY	CURRENCY_PAIR
ILSLVL=X	ILS/LVL	CCY	CURRENCY_PAIR
FJDCAD=X	FJD/CAD	CCY	CURRENCY_PAIR
NOKLVL=X	NOK/LVL	CCY	CURRENCY_PAIR
HU53.EX	HU53.EX	EUX	CURRENCY_PAIR
881341.HE	881341.HE	HEL	CURRENCY_PAIR
HF30.EX			CURRENCY_PAIR
FRF=X	USD/FRF	CCY	CURRENCY_PAIR
FSH1.EX	FSH1.EX	EUX	CURRENCY_PAIR
HU33.EX	HU33.EX	EUX	CURRENCY_PAIR
GELLVL=X	GEL/LVL	CCY	CURRENCY_PAIR
FJD=X	USD/FJD	CCY	CURRENCY_PAIR
FIMUSD=X			CURRENCY_PAIR
FJDUSD=X	FJD/USD	CCY	CURRENCY_PAIR
FKP=X	USD/FKP	CCY	CURRENCY_PAIR
FJDNZD=X	FJD/NZD	CCY	CURRENCY_PAIR
FJDAUD=X	FJD/AUD	CCY	CURRENCY_PAIR
FJDJPY=X	FJD/JPY	CCY	CURRENCY_PAIR
FJDEUR=X	FJD/EUR	CCY	CURRENCY_PAIR
881343.IR	881343.IR	ISE	CURRENCY_PAIR
HF43.EX			CURRENCY_PAIR
HU13.EX	HU13.EX	EUX	CURRENCY_PAIR
XDRLTL=X	XDR/LTL	CCY	CURRENCY_PAIR
FJDCHF=X	FJD/CHF	CCY	CURRENCY_PAIR
HF40.EX			CURRENCY_PAIR
LVLPLN=X	LVL/PLN	CCY	CURRENCY_PAIR
LTLCZK=X	LTL/CZK	CCY	CURRENCY_PAIR
LTLPLN=X	LTL/PLN	CCY	CURRENCY_PAIR
SGDLVL=X	SGD/LVL	CCY	CURRENCY_PAIR
FJDHKD=X	FJD/HKD	CCY	CURRENCY_PAIR
PLNLVL=X	PLN/LVL	CCY	CURRENCY_PAIR
FGFX.EX			CURRENCY_PAIR
HF53.EX	HF53.EX	EUX	CURRENCY_PAIR
FRFCHF=X	FRF/CHF	CCY	CURRENCY_PAIR
FKPUSD=X	FKP/USD	CCY	CURRENCY_PAIR
HKDLVL=X	HKD/LVL	CCY	CURRENCY_PAIR
RUBLVL=X	RUB/LVL	CCY	CURRENCY_PAIR
FJDDKK=X	FJD/DKK	CCY	CURRENCY_PAIR
14596345.EX			CURRENCY_PAIR
HF50.EX			CURRENCY_PAIR
HU23.EX			CURRENCY_PAIR
HF33.EX	HF33.EX	EUX	CURRENCY_PAIR
HU43.EX			CURRENCY_PAIR
HG23.EX			CURRENCY_PAIR
LTLLVL=X	LTL/LVL	CCY	CURRENCY_PAIR
HG13.EX	HG13.EX	EUX	CURRENCY_PAIR
FKPCHF=X	FKP/CHF	CCY	CURRENCY_PAIR
FCPU.EX			CURRENCY_PAIR
SEKLVL=X	SEK/LVL	CCY	CURRENCY_PAIR
KZTLTL=X	KZT/LTL	CCY	CURRENCY_PAIR
LVLCZK=X	LVL/CZK	CCY	CURRENCY_PAIR
FJDGBP=X	FJD/GBP	CCY	CURRENCY_PAIR
GBPUSD=X	GBP/USD	CCY	CURRENCY_PAIR
GBPJPY=X	GBP/JPY	CCY	CURRENCY_PAIR
GHSTWD=X	GHS/TWD	CCY	CURRENCY_PAIR
GBPZAR=X	GBP/ZAR	CCY	CURRENCY_PAIR
GBPNZD=X	GBP/NZD	CCY	CURRENCY_PAIR
GBPEUR=X	GBP/EUR	CCY	CURRENCY_PAIR
GBPCHF=X	GBP/CHF	CCY	CURRENCY_PAIR
GBP=X	USD/GBP	CCY	CURRENCY_PAIR
GHSTRY=X	GHS/TRY	CCY	CURRENCY_PAIR
GHSSEK=X	GHS/SEK	CCY	CURRENCY_PAIR
GHSOMR=X	GHS/OMR	CCY	CURRENCY_PAIR
GHSMAD=X	GHS/MAD	CCY	CURRENCY_PAIR
GHSCZK=X	GHS/CZK	CCY	CURRENCY_PAIR
GHSCOP=X	GHS/COP	CCY	CURRENCY_PAIR
GHSCNH=X	GHS/CNH	CCY	CURRENCY_PAIR
GHSBWP=X	GHS/BWP	CCY	CURRENCY_PAIR
GHSBRL=X	GHS/BRL	CCY	CURRENCY_PAIR
GHSBMD=X	Ghana Cedi (b) vs Bermuda Dolla	CCY	CURRENCY_PAIR
GBPZWL=X	GBP/ZWL	CCY	CURRENCY_PAIR
GBPUAH=X	GBP/UAH	CCY	CURRENCY_PAIR
GBPTRY=X	GBP/TRY	CCY	CURRENCY_PAIR
GBPTMT=X	GBP/TMT	CCY	CURRENCY_PAIR
GBPTHB=X	GBP/THB	CCY	CURRENCY_PAIR
GBPSLL=X	GBP/SLL	CCY	CURRENCY_PAIR
GBPSGD=X	GBP/SGD	CCY	CURRENCY_PAIR
GBPLRD=X	GBP/LRD	CCY	CURRENCY_PAIR
GBPKES=X	GBP/KES	CCY	CURRENCY_PAIR
GBPILS=X	GBP/ILS	CCY	CURRENCY_PAIR
GBPGNF=X	GBP/GNF	CCY	CURRENCY_PAIR
GBPFJD=X	GBP/FJD	CCY	CURRENCY_PAIR
GBPCAD=X	GBP/CAD	CCY	CURRENCY_PAIR
GBPBND=X	GBP/BND	CCY	CURRENCY_PAIR
GBPAUD=X	GBP/AUD	CCY	CURRENCY_PAIR
GBPANG=X	GBP/ANG	CCY	CURRENCY_PAIR
GBPAED=X	GBP/AED	CCY	CURRENCY_PAIR
GHSCLF=X	GHS/CLF	CCY	CURRENCY_PAIR
GBPJOD=X	GBP/JOD	CCY	CURRENCY_PAIR
GHSRON=X	GHS/RON	CCY	CURRENCY_PAIR
GELCHF=X	GEL/CHF	CCY	CURRENCY_PAIR
GBPGMD=X	GBP/GMD	CCY	CURRENCY_PAIR
GHSSBD=X	GHS/SBD	CCY	CURRENCY_PAIR
GHSTHB=X	GHS/THB	CCY	CURRENCY_PAIR
GHSQAR=X	GHS/QAR	CCY	CURRENCY_PAIR
GHSUGX=X	GHS/UGX	CCY	CURRENCY_PAIR
GBPBHD=X	GBP/BHD	CCY	CURRENCY_PAIR
GHSXDR=X	GHS/XDR	CCY	CURRENCY_PAIR
GBPFKP=X	GBP/FKP	CCY	CURRENCY_PAIR
GTQCAD=X	GTQ/CAD	CCY	CURRENCY_PAIR
19754110.SW			CURRENCY_PAIR
GBPBRL=X	GBP/BRL	CCY	CURRENCY_PAIR
GBPLVL=X	GBP/LVL	CCY	CURRENCY_PAIR
GELUSD=X	GEL/USD	CCY	CURRENCY_PAIR
GBPNPR=X	GBP/NPR	CCY	CURRENCY_PAIR
GHSPKR=X	GHS/PKR	CCY	CURRENCY_PAIR
GBPMYR=X	GBP/MYR	CCY	CURRENCY_PAIR
GTQGBP=X	GTQ/GBP	CCY	CURRENCY_PAIR
GBPAOA=X	GBP/AOA	CCY	CURRENCY_PAIR
GTQUSD=X	GTQ/USD	CCY	CURRENCY_PAIR
GHSKYD=X	GHS/KYD	CCY	CURRENCY_PAIR
GBPRUB=X	GBP/RUB	CCY	CURRENCY_PAIR
GHSAFN=X	Ghana Cedi (b) vs Afghanistan A	CCY	CURRENCY_PAIR
GBPLAK=X	GBP/LAK	CCY	CURRENCY_PAIR
GBPCVE=X	GBP/CVE	CCY	CURRENCY_PAIR
GBPIQD=X	GBP/IQD	CCY	CURRENCY_PAIR
GHSINR=X	GHS/INR	CCY	CURRENCY_PAIR
GHSMWK=X	GHS/MWK	CCY	CURRENCY_PAIR
GBPMOP=X	GBP/MOP	CCY	CURRENCY_PAIR
GBPARS=X	GBP/ARS	CCY	CURRENCY_PAIR
GBPAZN=X	GBP/AZN	CCY	CURRENCY_PAIR
GHS=X	USD/GHS	CCY	CURRENCY_PAIR
GBPAWG=X	GBP/AWG	CCY	CURRENCY_PAIR
GHSCLP=X	GHS/CLP	CCY	CURRENCY_PAIR
GBPMVR=X	GBP/MVR	CCY	CURRENCY_PAIR
GHSHUF=X	GHS/HUF	CCY	CURRENCY_PAIR
GTQEUR=X	GTQ/EUR	CCY	CURRENCY_PAIR
GNF=X	USD/GNF	CCY	CURRENCY_PAIR
GBPBDT=X	GBP/BDT	CCY	CURRENCY_PAIR
GHSLKR=X	GHS/LKR	CCY	CURRENCY_PAIR
GBPBTN=X	GBP/BTN	CCY	CURRENCY_PAIR
GBPHUF=X	GBP/HUF	CCY	CURRENCY_PAIR
GBPJMD=X	GBP/JMD	CCY	CURRENCY_PAIR
GIP=X	USD/GIP	CCY	CURRENCY_PAIR
GBPCOP=X	GBP/COP	CCY	CURRENCY_PAIR
GBPMKD=X	GBP/MKD	CCY	CURRENCY_PAIR
GHSBGN=X	GHS/BGN	CCY	CURRENCY_PAIR
GMDCHF=X	GMD/CHF	CCY	CURRENCY_PAIR
GHSVND=X	GHS/VND	CCY	CURRENCY_PAIR
GHSMUR=X	GHS/MUR	CCY	CURRENCY_PAIR
GBPRSD=X	GBP/RSD	CCY	CURRENCY_PAIR
GBPGEL=X	GBP/GEL	CCY	CURRENCY_PAIR
GHSIDR=X	GHS/IDR	CCY	CURRENCY_PAIR
GHSMOP=X	GHS/MOP	CCY	CURRENCY_PAIR
GBPMAD=X	GBP/MAD	CCY	CURRENCY_PAIR
GBPDOP=X	GBP/DOP	CCY	CURRENCY_PAIR
GBPMNT=X	GBP/MNT	CCY	CURRENCY_PAIR
GDO.AS			CURRENCY_PAIR
GBPHTG=X	GBP/HTG	CCY	CURRENCY_PAIR
GBPMXN=X	GBP/MXN	CCY	CURRENCY_PAIR
GHSTND=X	GHS/TND	CCY	CURRENCY_PAIR
GBPTND=X	GBP/TND	CCY	CURRENCY_PAIR
GMDEUR=X	GMD/EUR	CCY	CURRENCY_PAIR
GHSDKK=X	GHS/DKK	CCY	CURRENCY_PAIR
GBPPLN=X	GBP/PLN	CCY	CURRENCY_PAIR
GHSNZD=X	GHS/NZD	CCY	CURRENCY_PAIR
GBPPEN=X	GBP/PEN	CCY	CURRENCY_PAIR
GHSPEN=X	GHS/PEN	CCY	CURRENCY_PAIR
GBPCNH=X	GBP/CNH	CCY	CURRENCY_PAIR
GBPZMK=X			CURRENCY_PAIR
GBPCLP=X	GBP/CLP	CCY	CURRENCY_PAIR
GHSZAR=X	GHS/ZAR	CCY	CURRENCY_PAIR
GHSMYR=X	GHS/MYR	CCY	CURRENCY_PAIR
GBPCNY=X	GBP/CNY	CCY	CURRENCY_PAIR
GMDGBP=X	GMD/GBP	CCY	CURRENCY_PAIR
GBPSHP=X	GBP/SHP	CCY	CURRENCY_PAIR
GHSUSD=X	GHS/USD	CCY	CURRENCY_PAIR
GBPDJF=X	GBP/DJF	CCY	CURRENCY_PAIR
GLDUZ=X			CURRENCY_PAIR
GBPMDL=X	GBP/MDL	CCY	CURRENCY_PAIR
GBPTOP=X	GBP/TOP	CCY	CURRENCY_PAIR
GBPLYD=X	GBP/LYD	CCY	CURRENCY_PAIR
GHSAUD=X	GHS/AUD	CCY	CURRENCY_PAIR
GBPMGA=X	GBP/MGA	CCY	CURRENCY_PAIR
OCPF.EX	OCPF.EX	EUX	CURRENCY_PAIR
GBPBOB=X	GBP/BOB	CCY	CURRENCY_PAIR
GBPCUP=X	GBP/CUP	CCY	CURRENCY_PAIR
GBPOMR=X	GBP/OMR	CCY	CURRENCY_PAIR
GBPIDR=X	GBP/IDR	CCY	CURRENCY_PAIR
GBPXPF=X	GBP/XPF	CCY	CURRENCY_PAIR
GBPXDR=X	GBP/XDR	CCY	CURRENCY_PAIR
GBPCLF=X	GBP/CLF	CCY	CURRENCY_PAIR
19752592.SW			CURRENCY_PAIR
GBPISK=X	GBP/ISK	CCY	CURRENCY_PAIR
GBPUZS=X	GBP/UZS	CCY	CURRENCY_PAIR
GBPVND=X	GBP/VND	CCY	CURRENCY_PAIR
GBPNIO=X	GBP/NIO	CCY	CURRENCY_PAIR
GBPETB=X	GBP/ETB	CCY	CURRENCY_PAIR
GBPGHS=X	GBP/GHS	CCY	CURRENCY_PAIR
GBPYER=X	GBP/YER	CCY	CURRENCY_PAIR
GBPSRD=X	GBP/SRD	CCY	CURRENCY_PAIR
19753828.SW			CURRENCY_PAIR
GBPBIF=X	GBP/BIF	CCY	CURRENCY_PAIR
GBPGBP=X	GBP/GBP	CCY	CURRENCY_PAIR
GBPALL=X	GBP/ALL	CCY	CURRENCY_PAIR
GBPVEF=X	GBP/VEF	CCY	CURRENCY_PAIR
GELEUR=X	GEL/EUR	CCY	CURRENCY_PAIR
GBPBYR=X	GBP/BYR	CCY	CURRENCY_PAIR
GBPKGS=X	GBP/KGS	CCY	CURRENCY_PAIR
GBPDKK=X	GBP/DKK	CCY	CURRENCY_PAIR
GBPTZS=X	GBP/TZS	CCY	CURRENCY_PAIR
GHSXOF=X	GHS/XOF	CCY	CURRENCY_PAIR
GBPHNL=X	GBP/HNL	CCY	CURRENCY_PAIR
GHSWST=X	GHS/WST	CCY	CURRENCY_PAIR
GHSAED=X	Ghana Cedi (b) vs UAE Dirham Sp	CCY	CURRENCY_PAIR
GBPPKR=X	GBP/PKR	CCY	CURRENCY_PAIR
GBPCZK=X	GBP/CZK	CCY	CURRENCY_PAIR
GIPCHF=X	GIP/CHF	CCY	CURRENCY_PAIR
GHSILS=X	GHS/ILS	CCY	CURRENCY_PAIR
GEL=X	USD/GEL	CCY	CURRENCY_PAIR
GBPITL=X	GBP/ITL	CCY	CURRENCY_PAIR
GBPHRK=X	GBP/HRK	CCY	CURRENCY_PAIR
GBPNAD=X	GBP/NAD	CCY	CURRENCY_PAIR
GBPAMD=X	GBP/AMD	CCY	CURRENCY_PAIR
GBPBGN=X	GBP/BGN	CCY	CURRENCY_PAIR
GHSKWD=X	GHS/KWD	CCY	CURRENCY_PAIR
GHSGBP=X	GHS/GBP	CCY	CURRENCY_PAIR
GIPDKK=X	GIP/DKK	CCY	CURRENCY_PAIR
GBPXCD=X	GBP/XCD	CCY	CURRENCY_PAIR
GBPINR=X	GBP/INR	CCY	CURRENCY_PAIR
GBPWST=X	GBP/WST	CCY	CURRENCY_PAIR
GBPTWD=X	GBP/TWD	CCY	CURRENCY_PAIR
GHSFJD=X	GHS/FJD	CCY	CURRENCY_PAIR
GHSTOP=X	GHS/TOP	CCY	CURRENCY_PAIR
GTQCHF=X	GTQ/CHF	CCY	CURRENCY_PAIR
GBPKPW=X	GBP/KPW	CCY	CURRENCY_PAIR
GHSRUB=X	GHS/RUB	CCY	CURRENCY_PAIR
GHSBHD=X	GHS/BHD	CCY	CURRENCY_PAIR
GBPUYU=X	GBP/UYU	CCY	CURRENCY_PAIR
GBPSVC=X	GBP/SVC	CCY	CURRENCY_PAIR
GBPPHP=X	GBP/PHP	CCY	CURRENCY_PAIR
GBPSYP=X	GBP/SYP	CCY	CURRENCY_PAIR
GBPBAM=X	GBP/BAM	CCY	CURRENCY_PAIR
GBPZMW=X	GBP/ZMW	CCY	CURRENCY_PAIR
GHSRWF=X	GHS/RWF	CCY	CURRENCY_PAIR
19754106.SW			CURRENCY_PAIR
GHSPHP=X	GHS/PHP	CCY	CURRENCY_PAIR
GBPSAR=X	GBP/SAR	CCY	CURRENCY_PAIR
GHSZWL=X	GHS/ZWL	CCY	CURRENCY_PAIR
GBPSBD=X	GBP/SBD	CCY	CURRENCY_PAIR
GBPRON=X	GBP/RON	CCY	CURRENCY_PAIR
GBPPAB=X	GBP/PAB	CCY	CURRENCY_PAIR
GBPMUR=X	GBP/MUR	CCY	CURRENCY_PAIR
GHSNOK=X	GHS/NOK	CCY	CURRENCY_PAIR
274702=X			CURRENCY_PAIR
19754112.SW	19754112.SW	EBS	CURRENCY_PAIR
GBPKRW=X	GBP/KRW	CCY	CURRENCY_PAIR
19752528.SW	19752528.SW	EBS	CURRENCY_PAIR
GBPUGX=X	GBP/UGX	CCY	CURRENCY_PAIR
GHSBDT=X	GHS/BDT	CCY	CURRENCY_PAIR
GBPAFN=X	GBP/AFN	CCY	CURRENCY_PAIR
GHSRSD=X	GHS/RSD	CCY	CURRENCY_PAIR
19751807.SW			CURRENCY_PAIR
GHSTZS=X	GHS/TZS	CCY	CURRENCY_PAIR
GMDDKK=X	GMD/DKK	CCY	CURRENCY_PAIR
GBPKYD=X	GBP/KYD	CCY	CURRENCY_PAIR
GHSEGP=X	GHS/EGP	CCY	CURRENCY_PAIR
GHSNGN=X	GHS/NGN	CCY	CURRENCY_PAIR
GBPERN=X	GBP/ERN	CCY	CURRENCY_PAIR
GBPSDG=X	GBP/SDG	CCY	CURRENCY_PAIR
GBPVUV=X	GBP/VUV	CCY	CURRENCY_PAIR
GHSCAD=X	GHS/CAD	CCY	CURRENCY_PAIR
GBPSOS=X	GBP/SOS	CCY	CURRENCY_PAIR
GHSSAR=X	GHS/SAR	CCY	CURRENCY_PAIR
GHSARS=X	GHS/ARS	CCY	CURRENCY_PAIR
GTQ=X	USD/GTQ	CCY	CURRENCY_PAIR
GBPMWK=X	GBP/MWK	CCY	CURRENCY_PAIR
19754103.SW			CURRENCY_PAIR
GBPBMD=X	GBP/BMD	CCY	CURRENCY_PAIR
GHSANG=X	Ghana Cedi (b) vs Netherlands A	CCY	CURRENCY_PAIR
GBPBSD=X	GBP/BSD	CCY	CURRENCY_PAIR
GBPRWF=X	GBP/RWF	CCY	CURRENCY_PAIR
19752549.SW			CURRENCY_PAIR
GHSJOD=X	GHS/JOD	CCY	CURRENCY_PAIR
19752596.SW			CURRENCY_PAIR
GBPNOK=X	GBP/NOK	CCY	CURRENCY_PAIR
GBPLBP=X	GBP/LBP	CCY	CURRENCY_PAIR
1759700=X			CURRENCY_PAIR
19753401.SW			CURRENCY_PAIR
19752585.SW			CURRENCY_PAIR
GBPEGP=X	GBP/EGP	CCY	CURRENCY_PAIR
GBPLSL=X	GBP/LSL	CCY	CURRENCY_PAIR
19752571.SW	19752571.SW	EBS	CURRENCY_PAIR
GELGBP=X	GEL/GBP	CCY	CURRENCY_PAIR
GBPSCR=X	GBP/SCR	CCY	CURRENCY_PAIR
GMDUSD=X	GMD/USD	CCY	CURRENCY_PAIR
HG10.EX			CURRENCY_PAIR
19752593.SW			CURRENCY_PAIR
GBPLKR=X	GBP/LKR	CCY	CURRENCY_PAIR
GBPDZD=X	GBP/DZD	CCY	CURRENCY_PAIR
GHSEUR=X	GHS/EUR	CCY	CURRENCY_PAIR
GBPPYG=X	GBP/PYG	CCY	CURRENCY_PAIR
GBPIRR=X	GBP/IRR	CCY	CURRENCY_PAIR
GBPMMK=X	GBP/MMK	CCY	CURRENCY_PAIR
GBPGYD=X	GBP/GYD	CCY	CURRENCY_PAIR
GBPSZL=X	GBP/SZL	CCY	CURRENCY_PAIR
GBPXOF=X	GBP/XOF	CCY	CURRENCY_PAIR
GBPBBD=X	GBP/BBD	CCY	CURRENCY_PAIR
GHSCNY=X	GHS/CNY	CCY	CURRENCY_PAIR
GBPXAF=X	GBP/XAF	CCY	CURRENCY_PAIR
GHSNAD=X	GHS/NAD	CCY	CURRENCY_PAIR
GHSSGD=X	GHS/SGD	CCY	CURRENCY_PAIR
GBPGIP=X	GBP/GIP	CCY	CURRENCY_PAIR
GBPQAR=X	GBP/QAR	CCY	CURRENCY_PAIR
GHSZMW=X	GHS/ZMW	CCY	CURRENCY_PAIR
GBPMZN=X	GBP/MZN	CCY	CURRENCY_PAIR
19752531.SW			CURRENCY_PAIR
GBPGTQ=X	GBP/GTQ	CCY	CURRENCY_PAIR
GHSISK=X	GHS/ISK	CCY	CURRENCY_PAIR
GHSKZT=X	GHS/KZT	CCY	CURRENCY_PAIR
GBPKZT=X	GBP/KZT	CCY	CURRENCY_PAIR
19753383.SW	19753383.SW	EBS	CURRENCY_PAIR
GMD=X	USD/GMD	CCY	CURRENCY_PAIR
GHSHKD=X	GHS/HKD	CCY	CURRENCY_PAIR
HG20.EX	HG20.EX	EUX	CURRENCY_PAIR
GBPMRO=X	GBP/MRO	CCY	CURRENCY_PAIR
GBPKHR=X	GBP/KHR	CCY	CURRENCY_PAIR
GBPTTD=X	GBP/TTD	CCY	CURRENCY_PAIR
GBPLTL=X	GBP/LTL	CCY	CURRENCY_PAIR
GDO.NX	GDO.NX	ENX	CURRENCY_PAIR
GHSMXN=X	GHS/MXN	CCY	CURRENCY_PAIR
GBPCDF=X	GBP/CDF	CCY	CURRENCY_PAIR
GBPHKD=X	GBP/HKD	CCY	CURRENCY_PAIR
GBPCRC=X	GBP/CRC	CCY	CURRENCY_PAIR
GHSJPY=X	GHS/JPY	CCY	CURRENCY_PAIR
GHSKES=X	GHS/KES	CCY	CURRENCY_PAIR
GBPPGK=X	GBP/PGK	CCY	CURRENCY_PAIR
GBPSEK=X	GBP/SEK	CCY	CURRENCY_PAIR
GHSHRK=X	GHS/HRK	CCY	CURRENCY_PAIR
GBPBWP=X	GBP/BWP	CCY	CURRENCY_PAIR
GBPBZD=X	GBP/BZD	CCY	CURRENCY_PAIR
GBPNGN=X	GBP/NGN	CCY	CURRENCY_PAIR
GIPUSD=X	GIP/USD	CCY	CURRENCY_PAIR
GBPKMF=X	GBP/KMF	CCY	CURRENCY_PAIR
GBPSTD=X	GBP/STD	CCY	CURRENCY_PAIR
GBPTJS=X	GBP/TJS	CCY	CURRENCY_PAIR
GHSKRW=X	GHS/KRW	CCY	CURRENCY_PAIR
GHSPGK=X	GHS/PGK	CCY	CURRENCY_PAIR
GYD=X	USD/GYD	CCY	CURRENCY_PAIR
GBPKWD=X	GBP/KWD	CCY	CURRENCY_PAIR
HKDUSD=X	HKD/USD	CCY	CURRENCY_PAIR
HKDCNY=X	HKD/CNY	CCY	CURRENCY_PAIR
HUFTRY=X	HUF/TRY	CCY	CURRENCY_PAIR
HUFTHB=X	HUF/THB	CCY	CURRENCY_PAIR
HUFSEK=X	HUF/SEK	CCY	CURRENCY_PAIR
HUFSAR=X	HUF/SAR	CCY	CURRENCY_PAIR
HUFHKD=X	HUF/HKD	CCY	CURRENCY_PAIR
HRKLTL=X	HRK/LTL	CCY	CURRENCY_PAIR
HNLCAD=X	HNL/CAD	CCY	CURRENCY_PAIR
HKDTND=X	HKD/TND	CCY	CURRENCY_PAIR
HKDPLN=X	HKD/PLN	CCY	CURRENCY_PAIR
HKDNGN=X	HKD/NGN	CCY	CURRENCY_PAIR
HKDMAD=X	HKD/MAD	CCY	CURRENCY_PAIR
HKDDKK=X	HKD/DKK	CCY	CURRENCY_PAIR
HKDCHF=X	HKD/CHF	CCY	CURRENCY_PAIR
HU10.EX			CURRENCY_PAIR
HNL=X	USD/HNL	CCY	CURRENCY_PAIR
HKDPHP=X	HKD/PHP	CCY	CURRENCY_PAIR
HUFUAH=X	HUF/UAH	CCY	CURRENCY_PAIR
HUFPLN=X	HUF/PLN	CCY	CURRENCY_PAIR
HUFRUB=X	HUF/RUB	CCY	CURRENCY_PAIR
HNLEUR=X	HNL/EUR	CCY	CURRENCY_PAIR
HUFTWD=X	HUF/TWD	CCY	CURRENCY_PAIR
HRKSGD=X	HRK/SGD	CCY	CURRENCY_PAIR
HKDJPY=X	HKD/JPY	CCY	CURRENCY_PAIR
HUFEGP=X	HUF/EGP	CCY	CURRENCY_PAIR
HUFMYR=X	HUF/MYR	CCY	CURRENCY_PAIR
HUFAUD=X	HUF/AUD	CCY	CURRENCY_PAIR
HUFLTL=X	HUF/LTL	CCY	CURRENCY_PAIR
HRKJPY=X	HRK/JPY	CCY	CURRENCY_PAIR
HUFCZK=X	HUF/CZK	CCY	CURRENCY_PAIR
HUFTND=X	HUF/TND	CCY	CURRENCY_PAIR
HRKAED=X	HRK/AED	CCY	CURRENCY_PAIR
HKDBHD=X	HKD/BHD	CCY	CURRENCY_PAIR
HRKAUD=X	HRK/AUD	CCY	CURRENCY_PAIR
HKDPKR=X	HKD/PKR	CCY	CURRENCY_PAIR
HKDSAR=X	HKD/SAR	CCY	CURRENCY_PAIR
HKDBOB=X	HKD/BOB	CCY	CURRENCY_PAIR
HRKCZK=X	HRK/CZK	CCY	CURRENCY_PAIR
HKDIDR=X	HKD/IDR	CCY	CURRENCY_PAIR
HU20.EX			CURRENCY_PAIR
HRKMKD=X	HRK/MKD	CCY	CURRENCY_PAIR
HRKCNY=X	HRK/CNY	CCY	CURRENCY_PAIR
HRKINR=X	HRK/INR	CCY	CURRENCY_PAIR
HTGGBP=X	HTG/GBP	CCY	CURRENCY_PAIR
HKDEUR=X	HKD/EUR	CCY	CURRENCY_PAIR
HKDTRY=X	HKD/TRY	CCY	CURRENCY_PAIR
HRKGBP=X	HRK/GBP	CCY	CURRENCY_PAIR
HUFBAM=X	HUF/BAM	CCY	CURRENCY_PAIR
HKD=X	USD/HKD	CCY	CURRENCY_PAIR
HUFJPY=X	HUF/JPY	CCY	CURRENCY_PAIR
HKDBRL=X	HKD/BRL	CCY	CURRENCY_PAIR
HUFNOK=X	HUF/NOK	CCY	CURRENCY_PAIR
HKDCNH=X	HKD/CNH	CCY	CURRENCY_PAIR
HKDCLP=X	HKD/CLP	CCY	CURRENCY_PAIR
29134342=X			CURRENCY_PAIR
HUFCAD=X	HUF/CAD	CCY	CURRENCY_PAIR
HUFKES=X	HUF/KES	CCY	CURRENCY_PAIR
HRKDKK=X	HRK/DKK	CCY	CURRENCY_PAIR
HKDLKR=X	HKD/LKR	CCY	CURRENCY_PAIR
HKDMOP=X	HKD/MOP	CCY	CURRENCY_PAIR
HKDAUD=X	HKD/AUD	CCY	CURRENCY_PAIR
HNLUSD=X	HNL/USD	CCY	CURRENCY_PAIR
HRKKWD=X	HRK/KWD	CCY	CURRENCY_PAIR
HKDUYU=X	HKD/UYU	CCY	CURRENCY_PAIR
HRKHKD=X	HRK/HKD	CCY	CURRENCY_PAIR
HRKBRL=X	HRK/BRL	CCY	CURRENCY_PAIR
HKDOMR=X	HKD/OMR	CCY	CURRENCY_PAIR
HUFMXN=X	HUF/MXN	CCY	CURRENCY_PAIR
HKDNZD=X	HKD/NZD	CCY	CURRENCY_PAIR
HRKZAR=X	HRK/ZAR	CCY	CURRENCY_PAIR
HKDLTL=X	HKD/LTL	CCY	CURRENCY_PAIR
HTGUSD=X	HTG/USD	CCY	CURRENCY_PAIR
HKDVND=X	HKD/VND	CCY	CURRENCY_PAIR
HKDLBP=X	HKD/LBP	CCY	CURRENCY_PAIR
HKDTHB=X	HKD/THB	CCY	CURRENCY_PAIR
HUFRON=X	HUF/RON	CCY	CURRENCY_PAIR
HUFBRL=X	HUF/BRL	CCY	CURRENCY_PAIR
HUFIDR=X	HUF/IDR	CCY	CURRENCY_PAIR
HU50.EX			CURRENCY_PAIR
HNLGBP=X	HNL/GBP	CCY	CURRENCY_PAIR
HKDCZK=X	HKD/CZK	CCY	CURRENCY_PAIR
HKDEGP=X	HKD/EGP	CCY	CURRENCY_PAIR
HKDAED=X	HKD/AED	CCY	CURRENCY_PAIR
HKDCOP=X	HKD/COP	CCY	CURRENCY_PAIR
HKDMYR=X	HKD/MYR	CCY	CURRENCY_PAIR
HRKPLN=X	HRK/PLN	CCY	CURRENCY_PAIR
HKDVEF=X	HKD/VEF	CCY	CURRENCY_PAIR
HRKNOK=X	HRK/NOK	CCY	CURRENCY_PAIR
HRKRSD=X	HRK/RSD	CCY	CURRENCY_PAIR
HKDRUB=X	HKD/RUB	CCY	CURRENCY_PAIR
HRKNZD=X	HRK/NZD	CCY	CURRENCY_PAIR
HRKCHF=X	HRK/CHF	CCY	CURRENCY_PAIR
HKDUGX=X	HKD/UGX	CCY	CURRENCY_PAIR
HUFMAD=X	HUF/MAD	CCY	CURRENCY_PAIR
HTGCHF=X	HTG/CHF	CCY	CURRENCY_PAIR
29134340=X			CURRENCY_PAIR
HKDGHS=X	HKD/GHS	CCY	CURRENCY_PAIR
HTGEUR=X	HTG/EUR	CCY	CURRENCY_PAIR
HKDMUR=X	HKD/MUR	CCY	CURRENCY_PAIR
HUFLKR=X	HUF/LKR	CCY	CURRENCY_PAIR
HNLCHF=X	HNL/CHF	CCY	CURRENCY_PAIR
HUFMUR=X	HUF/MUR	CCY	CURRENCY_PAIR
HKDBWP=X	HKD/BWP	CCY	CURRENCY_PAIR
29134341=X			CURRENCY_PAIR
HKDKRW=X	HKD/KRW	CCY	CURRENCY_PAIR
HTG=X	USD/HTG	CCY	CURRENCY_PAIR
HRKSEK=X	HRK/SEK	CCY	CURRENCY_PAIR
HUFQAR=X	HUF/QAR	CCY	CURRENCY_PAIR
HKDKWD=X	HKD/KWD	CCY	CURRENCY_PAIR
HKDBDT=X	HKD/BDT	CCY	CURRENCY_PAIR
HUFNZD=X	HUF/NZD	CCY	CURRENCY_PAIR
HKDQAR=X	HKD/QAR	CCY	CURRENCY_PAIR
HKDPEN=X	HKD/PEN	CCY	CURRENCY_PAIR
HKDHUF=X	HKD/HUF	CCY	CURRENCY_PAIR
HRKTHB=X	HRK/THB	CCY	CURRENCY_PAIR
HUFAED=X	HUF/AED	CCY	CURRENCY_PAIR
HUFISK=X	HUF/ISK	CCY	CURRENCY_PAIR
HUFINR=X	HUF/INR	CCY	CURRENCY_PAIR
HRKCAD=X	HRK/CAD	CCY	CURRENCY_PAIR
HUFDKK=X	HUF/DKK	CCY	CURRENCY_PAIR
HUFZAR=X	HUF/ZAR	CCY	CURRENCY_PAIR
HRKILS=X	HRK/ILS	CCY	CURRENCY_PAIR
HKDCAD=X	HKD/CAD	CCY	CURRENCY_PAIR
HU30.EX			CURRENCY_PAIR
HUFSGD=X	HUF/SGD	CCY	CURRENCY_PAIR
HKDTWD=X	HKD/TWD	CCY	CURRENCY_PAIR
HUFCNY=X	HUF/CNY	CCY	CURRENCY_PAIR
HRKRON=X	HRK/RON	CCY	CURRENCY_PAIR
HKDZWL=X	HKD/ZWL	CCY	CURRENCY_PAIR
HRKBAM=X	HRK/BAM	CCY	CURRENCY_PAIR
HUFRSD=X	HUF/RSD	CCY	CURRENCY_PAIR
HKDKES=X	HKD/KES	CCY	CURRENCY_PAIR
HRKEUR=X	HRK/EUR	CCY	CURRENCY_PAIR
HKDARS=X	HKD/ARS	CCY	CURRENCY_PAIR
HKDMXN=X	HKD/MXN	CCY	CURRENCY_PAIR
HRKRUB=X	HRK/RUB	CCY	CURRENCY_PAIR
HKDSGD=X	HKD/SGD	CCY	CURRENCY_PAIR
HUFKRW=X	HUF/KRW	CCY	CURRENCY_PAIR
HUFILS=X	HUF/ILS	CCY	CURRENCY_PAIR
HU40.EX	HU40.EX	EUX	CURRENCY_PAIR
HRKTRY=X	HRK/TRY	CCY	CURRENCY_PAIR
HUFPHP=X	HUF/PHP	CCY	CURRENCY_PAIR
HRKKRW=X	HRK/KRW	CCY	CURRENCY_PAIR
HKDINR=X	HKD/INR	CCY	CURRENCY_PAIR
HUF=X	USD/HUF	CCY	CURRENCY_PAIR
HKDILS=X	HKD/ILS	CCY	CURRENCY_PAIR
HKDJOD=X	HKD/JOD	CCY	CURRENCY_PAIR
HKDISK=X	HKD/ISK	CCY	CURRENCY_PAIR
HKDBMD=X	HKD/BMD	CCY	CURRENCY_PAIR
HRKUSD=X	HRK/USD	CCY	CURRENCY_PAIR
HKDZAR=X	HKD/ZAR	CCY	CURRENCY_PAIR
HRKUAH=X	HRK/UAH	CCY	CURRENCY_PAIR
ISKTRY=X	ISK/TRY	CCY	CURRENCY_PAIR
ISKMUR=X	ISK/MUR	CCY	CURRENCY_PAIR
ISKINR=X	ISK/INR	CCY	CURRENCY_PAIR
ISKGBP=X	ISK/GBP	CCY	CURRENCY_PAIR
ISKEGP=X	ISK/EGP	CCY	CURRENCY_PAIR
ISKCAD=X	ISK/CAD	CCY	CURRENCY_PAIR
INRTND=X	INR/TND	CCY	CURRENCY_PAIR
INRSGD=X	INR/SGD	CCY	CURRENCY_PAIR
INRMAD=X	INR/MAD	CCY	CURRENCY_PAIR
INRCAD=X	INR/CAD	CCY	CURRENCY_PAIR
INRBRL=X	INR/BRL	CCY	CURRENCY_PAIR
ILSPLN=X	ILS/PLN	CCY	CURRENCY_PAIR
ILSPHP=X	ILS/PHP	CCY	CURRENCY_PAIR
ILSMUR=X	ILS/MUR	CCY	CURRENCY_PAIR
ILSLTL=X	ILS/LTL	CCY	CURRENCY_PAIR
ILSHKD=X	ILS/HKD	CCY	CURRENCY_PAIR
ILSCNY=X	ILS/CNY	CCY	CURRENCY_PAIR
ILSCAD=X	ILS/CAD	CCY	CURRENCY_PAIR
IDR=X	USD/IDR	CCY	CURRENCY_PAIR
ISKILS=X	ISK/ILS	CCY	CURRENCY_PAIR
INRISK=X	INR/ISK	CCY	CURRENCY_PAIR
IDRKES=X	IDR/KES	CCY	CURRENCY_PAIR
ILSSGD=X	ILS/SGD	CCY	CURRENCY_PAIR
ILSCHF=X	ILS/CHF	CCY	CURRENCY_PAIR
INRLTL=X	INR/LTL	CCY	CURRENCY_PAIR
ILSJOD=X	ILS/JOD	CCY	CURRENCY_PAIR
ISKQAR=X	ISK/QAR	CCY	CURRENCY_PAIR
INRGHS=X	INR/GHS	CCY	CURRENCY_PAIR
INRAUD=X	INR/AUD	CCY	CURRENCY_PAIR
ILSRUB=X	ILS/RUB	CCY	CURRENCY_PAIR
ILSHUF=X	ILS/HUF	CCY	CURRENCY_PAIR
ILSGBP=X	ILS/GBP	CCY	CURRENCY_PAIR
ISKCNY=X	ISK/CNY	CCY	CURRENCY_PAIR
ISKHUF=X	ISK/HUF	CCY	CURRENCY_PAIR
ILSDKK=X	ILS/DKK	CCY	CURRENCY_PAIR
INRPLN=X	INR/PLN	CCY	CURRENCY_PAIR
ILSTND=X	ILS/TND	CCY	CURRENCY_PAIR
INR=X	USD/INR	CCY	CURRENCY_PAIR
INRMYR=X	INR/MYR	CCY	CURRENCY_PAIR
ILSAED=X	ILS/AED	CCY	CURRENCY_PAIR
INRCZK=X	INR/CZK	CCY	CURRENCY_PAIR
ILSNOK=X	ILS/NOK	CCY	CURRENCY_PAIR
ISKAED=X	ISK/AED	CCY	CURRENCY_PAIR
ILSKES=X	ILS/KES	CCY	CURRENCY_PAIR
ILSSAR=X	ILS/SAR	CCY	CURRENCY_PAIR
IDRGHS=X	IDR/GHS	CCY	CURRENCY_PAIR
ILSTRY=X	ILS/TRY	CCY	CURRENCY_PAIR
ISKEUR=X	ISK/EUR	CCY	CURRENCY_PAIR
IDRRUB=X	IDR/RUB	CCY	CURRENCY_PAIR
ISKLTL=X	ISK/LTL	CCY	CURRENCY_PAIR
IQD=X	USD/IQD	CCY	CURRENCY_PAIR
ISKCHF=X	ISK/CHF	CCY	CURRENCY_PAIR
ILSXDR=X	ILS/XDR	CCY	CURRENCY_PAIR
IDRINR=X	IDR/INR	CCY	CURRENCY_PAIR
INRPHP=X	INR/PHP	CCY	CURRENCY_PAIR
ILSZAR=X	ILS/ZAR	CCY	CURRENCY_PAIR
ILSSEK=X	ILS/SEK	CCY	CURRENCY_PAIR
ISKJPY=X	ISK/JPY	CCY	CURRENCY_PAIR
INRSEK=X	INR/SEK	CCY	CURRENCY_PAIR
INRIDR=X	INR/IDR	CCY	CURRENCY_PAIR
INRQAR=X	INR/QAR	CCY	CURRENCY_PAIR
IDRUGX=X	IDR/UGX	CCY	CURRENCY_PAIR
IRR=X	USD/IRR	CCY	CURRENCY_PAIR
ISKCZK=X	ISK/CZK	CCY	CURRENCY_PAIR
ISKKRW=X	ISK/KRW	CCY	CURRENCY_PAIR
INROMR=X	INR/OMR	CCY	CURRENCY_PAIR
ILSCZK=X	ILS/CZK	CCY	CURRENCY_PAIR
ISKXDR=X	ISK/XDR	CCY	CURRENCY_PAIR
IDRISK=X	IDR/ISK	CCY	CURRENCY_PAIR
29134344=X			CURRENCY_PAIR
INRDKK=X	INR/DKK	CCY	CURRENCY_PAIR
ISKRUB=X	ISK/RUB	CCY	CURRENCY_PAIR
INRLKR=X	INR/LKR	CCY	CURRENCY_PAIR
INRZAR=X	INR/ZAR	CCY	CURRENCY_PAIR
INRXDR=X	INR/XDR	CCY	CURRENCY_PAIR
INRJOD=X	INR/JOD	CCY	CURRENCY_PAIR
ISKTND=X	ISK/TND	CCY	CURRENCY_PAIR
ILSOMR=X	ILS/OMR	CCY	CURRENCY_PAIR
ILSINR=X	ILS/INR	CCY	CURRENCY_PAIR
INRUGX=X	INR/UGX	CCY	CURRENCY_PAIR
ISKUSD=X	ISK/USD	CCY	CURRENCY_PAIR
ILSTWD=X	ILS/TWD	CCY	CURRENCY_PAIR
IDRBWP=X	IDR/BWP	CCY	CURRENCY_PAIR
INRGBP=X	INR/GBP	CCY	CURRENCY_PAIR
INRJPY=X	INR/JPY	CCY	CURRENCY_PAIR
ILSUSD=X	ILS/USD	CCY	CURRENCY_PAIR
INRKES=X	INR/KES	CCY	CURRENCY_PAIR
INRSAR=X	INR/SAR	CCY	CURRENCY_PAIR
INRRUB=X	INR/RUB	CCY	CURRENCY_PAIR
INREGP=X	INR/EGP	CCY	CURRENCY_PAIR
INRHKD=X	INR/HKD	CCY	CURRENCY_PAIR
ILSKRW=X	ILS/KRW	CCY	CURRENCY_PAIR
INRBWP=X	INR/BWP	CCY	CURRENCY_PAIR
INRCHF=X	INR/CHF	CCY	CURRENCY_PAIR
INRCNY=X	INR/CNY	CCY	CURRENCY_PAIR
ISKKES=X	ISK/KES	CCY	CURRENCY_PAIR
ISKJOD=X	ISK/JOD	CCY	CURRENCY_PAIR
ISKPLN=X	ISK/PLN	CCY	CURRENCY_PAIR
ISKHKD=X	ISK/HKD	CCY	CURRENCY_PAIR
ILSMXN=X	ILS/MXN	CCY	CURRENCY_PAIR
ISKDKK=X	ISK/DKK	CCY	CURRENCY_PAIR
ILSIDR=X	ILS/IDR	CCY	CURRENCY_PAIR
IEP=X	USD/IEP	CCY	CURRENCY_PAIR
ISKMAD=X	ISK/MAD	CCY	CURRENCY_PAIR
INRUSD=X	INR/USD	CCY	CURRENCY_PAIR
ISKIDR=X	ISK/IDR	CCY	CURRENCY_PAIR
ISKMXN=X	ISK/MXN	CCY	CURRENCY_PAIR
ISKZAR=X	ISK/ZAR	CCY	CURRENCY_PAIR
ISKLKR=X	ISK/LKR	CCY	CURRENCY_PAIR
IDRHUF=X	IDR/HUF	CCY	CURRENCY_PAIR
INRAED=X	INR/AED	CCY	CURRENCY_PAIR
ISKNOK=X	ISK/NOK	CCY	CURRENCY_PAIR
INRILS=X	INR/ILS	CCY	CURRENCY_PAIR
INREUR=X	INR/EUR	CCY	CURRENCY_PAIR
29134345=X			CURRENCY_PAIR
IEPUSD=X	IEP/USD	CCY	CURRENCY_PAIR
ILSMAD=X	ILS/MAD	CCY	CURRENCY_PAIR
ILSTHB=X	ILS/THB	CCY	CURRENCY_PAIR
IDRLKR=X	IDR/LKR	CCY	CURRENCY_PAIR
ILSJPY=X	ILS/JPY	CCY	CURRENCY_PAIR
ILSCLP=X	ILS/CLP	CCY	CURRENCY_PAIR
ISKTHB=X	ISK/THB	CCY	CURRENCY_PAIR
INRNOK=X	INR/NOK	CCY	CURRENCY_PAIR
ISKTWD=X	ISK/TWD	CCY	CURRENCY_PAIR
INRTZS=X	INR/TZS	CCY	CURRENCY_PAIR
INRMXN=X	INR/MXN	CCY	CURRENCY_PAIR
INMUA.NX			CURRENCY_PAIR
INRMUR=X	INR/MUR	CCY	CURRENCY_PAIR
INRLVL=X	INR/LVL	CCY	CURRENCY_PAIR
INRHUF=X	INR/HUF	CCY	CURRENCY_PAIR
ILSKWD=X	ILS/KWD	CCY	CURRENCY_PAIR
ILSISK=X	ILS/ISK	CCY	CURRENCY_PAIR
ILSAUD=X	ILS/AUD	CCY	CURRENCY_PAIR
IDRKRW=X	IDR/KRW	CCY	CURRENCY_PAIR
ISKNZD=X	ISK/NZD	CCY	CURRENCY_PAIR
ILS=X	USD/ILS	CCY	CURRENCY_PAIR
ILSBRL=X	ILS/BRL	CCY	CURRENCY_PAIR
INRTRY=X	INR/TRY	CCY	CURRENCY_PAIR
INRBGN=X	INR/BGN	CCY	CURRENCY_PAIR
IDRJPY=X	IDR/JPY	CCY	CURRENCY_PAIR
ISKSAR=X	ISK/SAR	CCY	CURRENCY_PAIR
INRTHB=X	INR/THB	CCY	CURRENCY_PAIR
INMUA.PA	LYXOR MUA INAV	PAR	CURRENCY_PAIR
ILSEGP=X	ILS/EGP	CCY	CURRENCY_PAIR
ISKAUD=X	ISK/AUD	CCY	CURRENCY_PAIR
INRKRW=X	INR/KRW	CCY	CURRENCY_PAIR
ISKSGD=X	ISK/SGD	CCY	CURRENCY_PAIR
INRPKR=X	INR/PKR	CCY	CURRENCY_PAIR
INRNZD=X	INR/NZD	CCY	CURRENCY_PAIR
ISKPHP=X	ISK/PHP	CCY	CURRENCY_PAIR
ISK=X	USD/ISK	CCY	CURRENCY_PAIR
ILSQAR=X	ILS/QAR	CCY	CURRENCY_PAIR
INRTWD=X	INR/TWD	CCY	CURRENCY_PAIR
ILSNZD=X	ILS/NZD	CCY	CURRENCY_PAIR
ISKSEK=X	ISK/SEK	CCY	CURRENCY_PAIR
IEPCHF=X	IEP/CHF	CCY	CURRENCY_PAIR
ILSLKR=X	ILS/LKR	CCY	CURRENCY_PAIR
JPYEUR=X	JPY/EUR	CCY	CURRENCY_PAIR
JPYUSD=X	JPY/USD	CCY	CURRENCY_PAIR
JPYGBP=X	JPY/GBP	CCY	CURRENCY_PAIR
JPY=X	USD/JPY	CCY	CURRENCY_PAIR
JPYNZD=X	JPY/NZD	CCY	CURRENCY_PAIR
JPYIQD=X	JPY/IQD	CCY	CURRENCY_PAIR
JPYZWL=X	JPY/ZWL	CCY	CURRENCY_PAIR
JPYXAF=X	JPY/XAF	CCY	CURRENCY_PAIR
JPYTJS=X	JPY/TJS	CCY	CURRENCY_PAIR
JPYSVC=X	JPY/SVC	CCY	CURRENCY_PAIR
JPYRON=X	JPY/RON	CCY	CURRENCY_PAIR
JPYNAD=X	JPY/NAD	CCY	CURRENCY_PAIR
JPYMMK=X	JPY/MMK	CCY	CURRENCY_PAIR
JPYLYD=X	JPY/LYD	CCY	CURRENCY_PAIR
JPYKGS=X	JPY/KGS	CCY	CURRENCY_PAIR
JPYILS=X	JPY/ILS	CCY	CURRENCY_PAIR
JPYCRC=X	JPY/CRC	CCY	CURRENCY_PAIR
JPYCNY=X	JPY/CNY	CCY	CURRENCY_PAIR
JPYAUD=X	JPY/AUD	CCY	CURRENCY_PAIR
JPYAFN=X	JPY/AFN	CCY	CURRENCY_PAIR
JODTHB=X	JOD/THB	CCY	CURRENCY_PAIR
JODSEK=X	JOD/SEK	CCY	CURRENCY_PAIR
JODRUB=X	JOD/RUB	CCY	CURRENCY_PAIR
JODKRW=X	JOD/KRW	CCY	CURRENCY_PAIR
JODILS=X	JOD/ILS	CCY	CURRENCY_PAIR
JODDKK=X	JOD/DKK	CCY	CURRENCY_PAIR
JPYGMD=X	JPY/GMD	CCY	CURRENCY_PAIR
JPYZMK=X			CURRENCY_PAIR
JMDCHF=X	JMD/CHF	CCY	CURRENCY_PAIR
JPYRWF=X	JPY/RWF	CCY	CURRENCY_PAIR
JPYGHS=X	JPY/GHS	CCY	CURRENCY_PAIR
JODCAD=X	JOD/CAD	CCY	CURRENCY_PAIR
JODAUD=X	JOD/AUD	CCY	CURRENCY_PAIR
JODKWD=X	JOD/KWD	CCY	CURRENCY_PAIR
JODLTL=X	JOD/LTL	CCY	CURRENCY_PAIR
JPYKZT=X	JPY/KZT	CCY	CURRENCY_PAIR
JPYAED=X	JPY/AED	CCY	CURRENCY_PAIR
JPYHTG=X	JPY/HTG	CCY	CURRENCY_PAIR
JPYKHR=X	JPY/KHR	CCY	CURRENCY_PAIR
JPYKMF=X	JPY/KMF	CCY	CURRENCY_PAIR
JMDGBP=X	JMD/GBP	CCY	CURRENCY_PAIR
JPYBGN=X	JPY/BGN	CCY	CURRENCY_PAIR
JPYCVE=X	JPY/CVE	CCY	CURRENCY_PAIR
JPYSLL=X	JPY/SLL	CCY	CURRENCY_PAIR
JPYSHP=X	JPY/SHP	CCY	CURRENCY_PAIR
JODMXN=X	JOD/MXN	CCY	CURRENCY_PAIR
JPYKPW=X	JPY/KPW	CCY	CURRENCY_PAIR
JPYCAD=X	JPY/CAD	CCY	CURRENCY_PAIR
JPYMNT=X	JPY/MNT	CCY	CURRENCY_PAIR
JPYCDF=X	JPY/CDF	CCY	CURRENCY_PAIR
JPYBYR=X	JPY/BYR	CCY	CURRENCY_PAIR
JPYBIF=X	JPY/BIF	CCY	CURRENCY_PAIR
JODLKR=X	JOD/LKR	CCY	CURRENCY_PAIR
JODTWD=X	JOD/TWD	CCY	CURRENCY_PAIR
JPYBTN=X	JPY/BTN	CCY	CURRENCY_PAIR
JPYHKD=X	JPY/HKD	CCY	CURRENCY_PAIR
JPYTMT=X	JPY/TMT	CCY	CURRENCY_PAIR
JMDCAD=X	JMD/CAD	CCY	CURRENCY_PAIR
JODAED=X	JOD/AED	CCY	CURRENCY_PAIR
JPYGTQ=X	JPY/GTQ	CCY	CURRENCY_PAIR
JPYBND=X	JPY/BND	CCY	CURRENCY_PAIR
JPYDJF=X	JPY/DJF	CCY	CURRENCY_PAIR
JPYMDL=X	JPY/MDL	CCY	CURRENCY_PAIR
JPYUAH=X	JPY/UAH	CCY	CURRENCY_PAIR
JPYXPF=X	JPY/XPF	CCY	CURRENCY_PAIR
JPYSZL=X	JPY/SZL	CCY	CURRENCY_PAIR
JPYBZD=X	JPY/BZD	CCY	CURRENCY_PAIR
JPYMVR=X	JPY/MVR	CCY	CURRENCY_PAIR
JODSAR=X	JOD/SAR	CCY	CURRENCY_PAIR
JPYERN=X	JPY/ERN	CCY	CURRENCY_PAIR
JPYBOB=X	JPY/BOB	CCY	CURRENCY_PAIR
JODPLN=X	JOD/PLN	CCY	CURRENCY_PAIR
JPYVUV=X	JPY/VUV	CCY	CURRENCY_PAIR
JODCNY=X	JOD/CNY	CCY	CURRENCY_PAIR
JPYWST=X	JPY/WST	CCY	CURRENCY_PAIR
JPYBDT=X	JPY/BDT	CCY	CURRENCY_PAIR
JODNOK=X	JOD/NOK	CCY	CURRENCY_PAIR
JPYFJD=X	JPY/FJD	CCY	CURRENCY_PAIR
JPYMXN=X	JPY/MXN	CCY	CURRENCY_PAIR
JPYMGA=X	JPY/MGA	CCY	CURRENCY_PAIR
JPYJMD=X	JPY/JMD	CCY	CURRENCY_PAIR
JPYZMW=X	JPY/ZMW	CCY	CURRENCY_PAIR
JPYNGN=X	JPY/NGN	CCY	CURRENCY_PAIR
JODQAR=X	JOD/QAR	CCY	CURRENCY_PAIR
JPYSBD=X	JPY/SBD	CCY	CURRENCY_PAIR
JPYLRD=X	JPY/LRD	CCY	CURRENCY_PAIR
JPYLBP=X	JPY/LBP	CCY	CURRENCY_PAIR
JPYDOP=X	JPY/DOP	CCY	CURRENCY_PAIR
JPYIRR=X	JPY/IRR	CCY	CURRENCY_PAIR
JPYETB=X	JPY/ETB	CCY	CURRENCY_PAIR
JPYCNH=X	JPY/CNH	CCY	CURRENCY_PAIR
JPYISK=X	JPY/ISK	CCY	CURRENCY_PAIR
JPYTOP=X	JPY/TOP	CCY	CURRENCY_PAIR
JPYMUR=X	JPY/MUR	CCY	CURRENCY_PAIR
JPYPKR=X	JPY/PKR	CCY	CURRENCY_PAIR
JPYITL=X	JPY/ITL	CCY	CURRENCY_PAIR
JPYCZK=X	JPY/CZK	CCY	CURRENCY_PAIR
JPYCLP=X	JPY/CLP	CCY	CURRENCY_PAIR
JODCZK=X	JOD/CZK	CCY	CURRENCY_PAIR
JPYPYG=X	JPY/PYG	CCY	CURRENCY_PAIR
JPYMOP=X	JPY/MOP	CCY	CURRENCY_PAIR
JPYDKK=X	JPY/DKK	CCY	CURRENCY_PAIR
JPYLSL=X	JPY/LSL	CCY	CURRENCY_PAIR
JPYSRD=X	JPY/SRD	CCY	CURRENCY_PAIR
JPYSYP=X	JPY/SYP	CCY	CURRENCY_PAIR
JPYKRW=X	JPY/KRW	CCY	CURRENCY_PAIR
JPYBMD=X	JPY/BMD	CCY	CURRENCY_PAIR
JODPHP=X	JOD/PHP	CCY	CURRENCY_PAIR
JPYFKP=X	JPY/FKP	CCY	CURRENCY_PAIR
JPYAMD=X	JPY/AMD	CCY	CURRENCY_PAIR
JPYMKD=X	JPY/MKD	CCY	CURRENCY_PAIR
JPYLAK=X	JPY/LAK	CCY	CURRENCY_PAIR
JPYRUB=X	JPY/RUB	CCY	CURRENCY_PAIR
JODLVL=X	JOD/LVL	CCY	CURRENCY_PAIR
JPYMZN=X	JPY/MZN	CCY	CURRENCY_PAIR
JPYTTD=X	JPY/TTD	CCY	CURRENCY_PAIR
JMD=X	USD/JMD	CCY	CURRENCY_PAIR
JPYAZN=X	JPY/AZN	CCY	CURRENCY_PAIR
JPYYER=X	JPY/YER	CCY	CURRENCY_PAIR
JMDUSD=X	JMD/USD	CCY	CURRENCY_PAIR
JODGBP=X	JOD/GBP	CCY	CURRENCY_PAIR
JPYBRL=X	JPY/BRL	CCY	CURRENCY_PAIR
JPYGYD=X	JPY/GYD	CCY	CURRENCY_PAIR
JPYNOK=X	JPY/NOK	CCY	CURRENCY_PAIR
JPYXOF=X	JPY/XOF	CCY	CURRENCY_PAIR
JPYTZS=X	JPY/TZS	CCY	CURRENCY_PAIR
JPYAOA=X	JPY/AOA	CCY	CURRENCY_PAIR
JODEUR=X	JOD/EUR	CCY	CURRENCY_PAIR
JPYBBD=X	JPY/BBD	CCY	CURRENCY_PAIR
JPYPAB=X	JPY/PAB	CCY	CURRENCY_PAIR
JPYMYR=X	JPY/MYR	CCY	CURRENCY_PAIR
JPYINR=X	JPY/INR	CCY	CURRENCY_PAIR
JODEGP=X	JOD/EGP	CCY	CURRENCY_PAIR
JPYTND=X	JPY/TND	CCY	CURRENCY_PAIR
JPYLTL=X	JPY/LTL	CCY	CURRENCY_PAIR
JODCHF=X	JOD/CHF	CCY	CURRENCY_PAIR
JPYGNF=X	JPY/GNF	CCY	CURRENCY_PAIR
JPYIDR=X	JPY/IDR	CCY	CURRENCY_PAIR
JPYSTD=X	JPY/STD	CCY	CURRENCY_PAIR
JODTRY=X	JOD/TRY	CCY	CURRENCY_PAIR
JPYBWP=X	JPY/BWP	CCY	CURRENCY_PAIR
JPYGIP=X	JPY/GIP	CCY	CURRENCY_PAIR
JPYANG=X	JPY/ANG	CCY	CURRENCY_PAIR
JPYUZS=X	JPY/UZS	CCY	CURRENCY_PAIR
JODKES=X	JOD/KES	CCY	CURRENCY_PAIR
JPYEGP=X	JPY/EGP	CCY	CURRENCY_PAIR
JPYBSD=X	JPY/BSD	CCY	CURRENCY_PAIR
JPYRSD=X	JPY/RSD	CCY	CURRENCY_PAIR
JPYXDR=X	JPY/XDR	CCY	CURRENCY_PAIR
JODINR=X	JOD/INR	CCY	CURRENCY_PAIR
JPYZAR=X	JPY/ZAR	CCY	CURRENCY_PAIR
JPYJOD=X	JPY/JOD	CCY	CURRENCY_PAIR
JPYAWG=X	JPY/AWG	CCY	CURRENCY_PAIR
JPYXCD=X	JPY/XCD	CCY	CURRENCY_PAIR
JPYMRO=X	JPY/MRO	CCY	CURRENCY_PAIR
JPYMWK=X	JPY/MWK	CCY	CURRENCY_PAIR
JPYSEK=X	JPY/SEK	CCY	CURRENCY_PAIR
JPYTHB=X	JPY/THB	CCY	CURRENCY_PAIR
JODHUF=X	JOD/HUF	CCY	CURRENCY_PAIR
JPYQAR=X	JPY/QAR	CCY	CURRENCY_PAIR
JPYCHF=X	JPY/CHF	CCY	CURRENCY_PAIR
JODIDR=X	JOD/IDR	CCY	CURRENCY_PAIR
JMDDKK=X	JMD/DKK	CCY	CURRENCY_PAIR
JODZAR=X	JOD/ZAR	CCY	CURRENCY_PAIR
JODHKD=X	JOD/HKD	CCY	CURRENCY_PAIR
JODJPY=X	JOD/JPY	CCY	CURRENCY_PAIR
JODAMD=X	JOD/AMD	CCY	CURRENCY_PAIR
JPYPEN=X	JPY/PEN	CCY	CURRENCY_PAIR
JPYLVL=X	JPY/LVL	CCY	CURRENCY_PAIR
JOD=X	USD/JOD	CCY	CURRENCY_PAIR
JODTND=X	JOD/TND	CCY	CURRENCY_PAIR
JPYHRK=X	JPY/HRK	CCY	CURRENCY_PAIR
JPYNPR=X	JPY/NPR	CCY	CURRENCY_PAIR
JPYSCR=X	JPY/SCR	CCY	CURRENCY_PAIR
JODMUR=X	JOD/MUR	CCY	CURRENCY_PAIR
JPYMAD=X	JPY/MAD	CCY	CURRENCY_PAIR
JPYALL=X	JPY/ALL	CCY	CURRENCY_PAIR
JODOMR=X	JOD/OMR	CCY	CURRENCY_PAIR
JPYKYD=X	JPY/KYD	CCY	CURRENCY_PAIR
JPYSDG=X	JPY/SDG	CCY	CURRENCY_PAIR
JPYHUF=X	JPY/HUF	CCY	CURRENCY_PAIR
JPYPGK=X	JPY/PGK	CCY	CURRENCY_PAIR
JPYSAR=X	JPY/SAR	CCY	CURRENCY_PAIR
JPYCOP=X	JPY/COP	CCY	CURRENCY_PAIR
JODSGD=X	JOD/SGD	CCY	CURRENCY_PAIR
JPYARS=X	JPY/ARS	CCY	CURRENCY_PAIR
JODMAD=X	JOD/MAD	CCY	CURRENCY_PAIR
JPYSGD=X	JPY/SGD	CCY	CURRENCY_PAIR
JPYUGX=X	JPY/UGX	CCY	CURRENCY_PAIR
JPYSOS=X	JPY/SOS	CCY	CURRENCY_PAIR
JMDEUR=X	JMD/EUR	CCY	CURRENCY_PAIR
JPYNIO=X	JPY/NIO	CCY	CURRENCY_PAIR
JPYHNL=X	JPY/HNL	CCY	CURRENCY_PAIR
JODUSD=X	JOD/USD	CCY	CURRENCY_PAIR
JPYTWD=X	JPY/TWD	CCY	CURRENCY_PAIR
JPYBAM=X	JPY/BAM	CCY	CURRENCY_PAIR
JPYVEF=X	JPY/VEF	CCY	CURRENCY_PAIR
JPYCUP=X	JPY/CUP	CCY	CURRENCY_PAIR
JPYPHP=X	JPY/PHP	CCY	CURRENCY_PAIR
JODNZD=X	JOD/NZD	CCY	CURRENCY_PAIR
JPYKES=X	JPY/KES	CCY	CURRENCY_PAIR
JPYUYU=X	JPY/UYU	CCY	CURRENCY_PAIR
JPYPLN=X	JPY/PLN	CCY	CURRENCY_PAIR
JPYVND=X	JPY/VND	CCY	CURRENCY_PAIR
JPYGEL=X	JPY/GEL	CCY	CURRENCY_PAIR
JPYLKR=X	JPY/LKR	CCY	CURRENCY_PAIR
JPYDZD=X	JPY/DZD	CCY	CURRENCY_PAIR
KZTDKK=X	KZT/DKK	CCY	CURRENCY_PAIR
KWDTWD=X	KWD/TWD	CCY	CURRENCY_PAIR
KWDSEK=X	KWD/SEK	CCY	CURRENCY_PAIR
KWDPLN=X	KWD/PLN	CCY	CURRENCY_PAIR
KWDPKR=X	KWD/PKR	CCY	CURRENCY_PAIR
KWDCZK=X	KWD/CZK	CCY	CURRENCY_PAIR
KRWPHP=X	KRW/PHP	CCY	CURRENCY_PAIR
KRWLKR=X	KRW/LKR	CCY	CURRENCY_PAIR
KRWJPY=X	KRW/JPY	CCY	CURRENCY_PAIR
KRWISK=X	KRW/ISK	CCY	CURRENCY_PAIR
KGSCHF=X	KGS/CHF	CCY	CURRENCY_PAIR
KESTND=X	KES/TND	CCY	CURRENCY_PAIR
KESSAR=X	KES/SAR	CCY	CURRENCY_PAIR
KESQAR=X	KES/QAR	CCY	CURRENCY_PAIR
KESLVL=X	KES/LVL	CCY	CURRENCY_PAIR
KESHKD=X	KES/HKD	CCY	CURRENCY_PAIR
KESCZK=X	KES/CZK	CCY	CURRENCY_PAIR
KESLKR=X	KES/LKR	CCY	CURRENCY_PAIR
KWDLTL=X	KWD/LTL	CCY	CURRENCY_PAIR
KGSGBP=X	KGS/GBP	CCY	CURRENCY_PAIR
KESJOD=X	KES/JOD	CCY	CURRENCY_PAIR
KWDOMR=X	KWD/OMR	CCY	CURRENCY_PAIR
KWDPHP=X	KWD/PHP	CCY	CURRENCY_PAIR
KRWTWD=X	KRW/TWD	CCY	CURRENCY_PAIR
KWDSAR=X	KWD/SAR	CCY	CURRENCY_PAIR
KRW=X	USD/KRW	CCY	CURRENCY_PAIR
KESZAR=X	KES/ZAR	CCY	CURRENCY_PAIR
KESRUB=X	KES/RUB	CCY	CURRENCY_PAIR
KWDEGP=X	KWD/EGP	CCY	CURRENCY_PAIR
KRWHKD=X	KRW/HKD	CCY	CURRENCY_PAIR
KES=X	USD/KES	CCY	CURRENCY_PAIR
KGSEUR=X	KGS/EUR	CCY	CURRENCY_PAIR
KRWZAR=X	KRW/ZAR	CCY	CURRENCY_PAIR
KESIDR=X	KES/IDR	CCY	CURRENCY_PAIR
KRWDKK=X	KRW/DKK	CCY	CURRENCY_PAIR
KESJPY=X	KES/JPY	CCY	CURRENCY_PAIR
KRWUGX=X	KRW/UGX	CCY	CURRENCY_PAIR
KRWHUF=X	KRW/HUF	CCY	CURRENCY_PAIR
KWDSGD=X	KWD/SGD	CCY	CURRENCY_PAIR
KRWINR=X	KRW/INR	CCY	CURRENCY_PAIR
KRWEGP=X	KRW/EGP	CCY	CURRENCY_PAIR
KESSGD=X	KES/SGD	CCY	CURRENCY_PAIR
KWD=X	USD/KWD	CCY	CURRENCY_PAIR
KESEUR=X	KES/EUR	CCY	CURRENCY_PAIR
KWDJPY=X	KWD/JPY	CCY	CURRENCY_PAIR
KWDMUR=X	KWD/MUR	CCY	CURRENCY_PAIR
KWDCHF=X	KWD/CHF	CCY	CURRENCY_PAIR
KGS=X	USD/KGS	CCY	CURRENCY_PAIR
KWDJOD=X	KWD/JOD	CCY	CURRENCY_PAIR
KWDTHB=X	KWD/THB	CCY	CURRENCY_PAIR
KESEGP=X	KES/EGP	CCY	CURRENCY_PAIR
KESGBP=X	KES/GBP	CCY	CURRENCY_PAIR
KRWBWP=X	KRW/BWP	CCY	CURRENCY_PAIR
KESMXN=X	KES/MXN	CCY	CURRENCY_PAIR
KWDNZD=X	KWD/NZD	CCY	CURRENCY_PAIR
20162407.SW			CURRENCY_PAIR
KMF=X	USD/KMF	CCY	CURRENCY_PAIR
KWDISK=X	KWD/ISK	CCY	CURRENCY_PAIR
KESNZD=X	KES/NZD	CCY	CURRENCY_PAIR
KRWMUR=X	KRW/MUR	CCY	CURRENCY_PAIR
KRWMXN=X	KRW/MXN	CCY	CURRENCY_PAIR
KYDUSD=X	KYD/USD	CCY	CURRENCY_PAIR
KWDNOK=X	KWD/NOK	CCY	CURRENCY_PAIR
KESMUR=X	KES/MUR	CCY	CURRENCY_PAIR
KWDHKD=X	KWD/HKD	CCY	CURRENCY_PAIR
KWDMXN=X	KWD/MXN	CCY	CURRENCY_PAIR
KRWMAD=X	KRW/MAD	CCY	CURRENCY_PAIR
KRWKES=X	KRW/KES	CCY	CURRENCY_PAIR
KESNOK=X	KES/NOK	CCY	CURRENCY_PAIR
KWDXDR=X	KWD/XDR	CCY	CURRENCY_PAIR
KRWTHB=X	KRW/THB	CCY	CURRENCY_PAIR
KWDRUB=X	KWD/RUB	CCY	CURRENCY_PAIR
KHR=X	USD/KHR	CCY	CURRENCY_PAIR
KWDINR=X	KWD/INR	CCY	CURRENCY_PAIR
KWDMAD=X	KWD/MAD	CCY	CURRENCY_PAIR
KESTRY=X	KES/TRY	CCY	CURRENCY_PAIR
KESAED=X	KES/AED	CCY	CURRENCY_PAIR
KWDBHD=X	KWD/BHD	CCY	CURRENCY_PAIR
KZT=X	USD/KZT	CCY	CURRENCY_PAIR
KWDRSD=X	KWD/RSD	CCY	CURRENCY_PAIR
KPW=X	USD/KPW	CCY	CURRENCY_PAIR
KESCHF=X	KES/CHF	CCY	CURRENCY_PAIR
KWDGBP=X	KWD/GBP	CCY	CURRENCY_PAIR
KYDEUR=X	KYD/EUR	CCY	CURRENCY_PAIR
KWDZAR=X	KWD/ZAR	CCY	CURRENCY_PAIR
KWDUSD=X	KWD/USD	CCY	CURRENCY_PAIR
KESMAD=X	KES/MAD	CCY	CURRENCY_PAIR
KESTWD=X	KES/TWD	CCY	CURRENCY_PAIR
KYDGBP=X	KYD/GBP	CCY	CURRENCY_PAIR
KESDKK=X	KES/DKK	CCY	CURRENCY_PAIR
KESPHP=X	KES/PHP	CCY	CURRENCY_PAIR
KWDILS=X	KWD/ILS	CCY	CURRENCY_PAIR
KWDTND=X	KWD/TND	CCY	CURRENCY_PAIR
KRWSEK=X	KRW/SEK	CCY	CURRENCY_PAIR
KWDDKK=X	KWD/DKK	CCY	CURRENCY_PAIR
KESAUD=X	KES/AUD	CCY	CURRENCY_PAIR
KWDHUF=X	KWD/HUF	CCY	CURRENCY_PAIR
KWDKES=X	KWD/KES	CCY	CURRENCY_PAIR
KRWRUB=X	KRW/RUB	CCY	CURRENCY_PAIR
KWDAED=X	Kuwaiti Dinar (b) vs UAE Dirham	CCY	CURRENCY_PAIR
KWDCNY=X	KWD/CNY	CCY	CURRENCY_PAIR
KWDEUR=X	KWD/EUR	CCY	CURRENCY_PAIR
KWDIDR=X	KWD/IDR	CCY	CURRENCY_PAIR
KESILS=X	KES/ILS	CCY	CURRENCY_PAIR
KWDTRY=X	KWD/TRY	CCY	CURRENCY_PAIR
KWDCAD=X	KWD/CAD	CCY	CURRENCY_PAIR
KESLTL=X	KES/LTL	CCY	CURRENCY_PAIR
KRWCZK=X	KRW/CZK	CCY	CURRENCY_PAIR
KESUSD=X	KES/USD	CCY	CURRENCY_PAIR
KYDCHF=X	KYD/CHF	CCY	CURRENCY_PAIR
KGSUSD=X	KGS/USD	CCY	CURRENCY_PAIR
KESTHB=X	KES/THB	CCY	CURRENCY_PAIR
KWDLVL=X	KWD/LVL	CCY	CURRENCY_PAIR
KESSEK=X	KES/SEK	CCY	CURRENCY_PAIR
KESPLN=X	KES/PLN	CCY	CURRENCY_PAIR
KRWCNY=X	KRW/CNY	CCY	CURRENCY_PAIR
KWDAUD=X	KWD/AUD	CCY	CURRENCY_PAIR
KESCAD=X	KES/CAD	CCY	CURRENCY_PAIR
KRWPKR=X	KRW/PKR	CCY	CURRENCY_PAIR
KRWIDR=X	KRW/IDR	CCY	CURRENCY_PAIR
KRWNOK=X	KRW/NOK	CCY	CURRENCY_PAIR
20162411.SW			CURRENCY_PAIR
KRWGHS=X	KRW/GHS	CCY	CURRENCY_PAIR
KYD=X	USD/KYD	CCY	CURRENCY_PAIR
KRWCRC=X	KRW/CRC	CCY	CURRENCY_PAIR
29134346=X			CURRENCY_PAIR
KWDLKR=X	KWD/LKR	CCY	CURRENCY_PAIR
KESKRW=X	KES/KRW	CCY	CURRENCY_PAIR
KESHUF=X	KES/HUF	CCY	CURRENCY_PAIR
KESCNY=X	KES/CNY	CCY	CURRENCY_PAIR
KWDQAR=X	KWD/QAR	CCY	CURRENCY_PAIR
LVLTHB=X	LVL/THB	CCY	CURRENCY_PAIR
LVLSGD=X	LVL/SGD	CCY	CURRENCY_PAIR
LVLSAR=X	LVL/SAR	CCY	CURRENCY_PAIR
LVLPHP=X	LVL/PHP	CCY	CURRENCY_PAIR
LTLTHB=X	LTL/THB	CCY	CURRENCY_PAIR
LTLSGD=X	LTL/SGD	CCY	CURRENCY_PAIR
LTLRUB=X	LTL/RUB	CCY	CURRENCY_PAIR
LTLKRW=X	LTL/KRW	CCY	CURRENCY_PAIR
LTLJOD=X	LTL/JOD	CCY	CURRENCY_PAIR
LTLAED=X	LTL/AED	CCY	CURRENCY_PAIR
LKRUSD=X	LKR/USD	CCY	CURRENCY_PAIR
LKRTHB=X	LKR/THB	CCY	CURRENCY_PAIR
LKRNOK=X	LKR/NOK	CCY	CURRENCY_PAIR
LKRJPY=X	LKR/JPY	CCY	CURRENCY_PAIR
LKRHKD=X	LKR/HKD	CCY	CURRENCY_PAIR
LKRCNY=X	LKR/CNY	CCY	CURRENCY_PAIR
LKRAUD=X	LKR/AUD	CCY	CURRENCY_PAIR
LVLAED=X	LVL/AED	CCY	CURRENCY_PAIR
LSL=X	USD/LSL	CCY	CURRENCY_PAIR
LKRJOD=X	LKR/JOD	CCY	CURRENCY_PAIR
LKR=X	USD/LKR	CCY	CURRENCY_PAIR
LTLPHP=X	LTL/PHP	CCY	CURRENCY_PAIR
LKRHUF=X	LKR/HUF	CCY	CURRENCY_PAIR
LVLKRW=X	LVL/KRW	CCY	CURRENCY_PAIR
LVLIDR=X	LVL/IDR	CCY	CURRENCY_PAIR
LTLLKR=X	LTL/LKR	CCY	CURRENCY_PAIR
LVLHUF=X	LVL/HUF	CCY	CURRENCY_PAIR
LTLKES=X	LTL/KES	CCY	CURRENCY_PAIR
LSLEUR=X	LSL/EUR	CCY	CURRENCY_PAIR
LTLGBP=X	LTL/GBP	CCY	CURRENCY_PAIR
LVLNOK=X	LVL/NOK	CCY	CURRENCY_PAIR
LKRCZK=X	LKR/CZK	CCY	CURRENCY_PAIR
LKRXDR=X	LKR/XDR	CCY	CURRENCY_PAIR
LTLRSD=X	LTL/RSD	CCY	CURRENCY_PAIR
LKRMUR=X	LKR/MUR	CCY	CURRENCY_PAIR
LVLDKK=X	LVL/DKK	CCY	CURRENCY_PAIR
LVLTRY=X	LVL/TRY	CCY	CURRENCY_PAIR
LKRQAR=X	LKR/QAR	CCY	CURRENCY_PAIR
LRD=X	USD/LRD	CCY	CURRENCY_PAIR
LVLZAR=X	LVL/ZAR	CCY	CURRENCY_PAIR
LTLMAD=X	LTL/MAD	CCY	CURRENCY_PAIR
LTLSEK=X	LTL/SEK	CCY	CURRENCY_PAIR
LVLGBP=X	LVL/GBP	CCY	CURRENCY_PAIR
LSLCHF=X	LSL/CHF	CCY	CURRENCY_PAIR
LYDMAD=X	LYD/MAD	CCY	CURRENCY_PAIR
LVLQAR=X	LVL/QAR	CCY	CURRENCY_PAIR
LVLCHF=X	LVL/CHF	CCY	CURRENCY_PAIR
LVLCAD=X	LVL/CAD	CCY	CURRENCY_PAIR
LVLKES=X	LVL/KES	CCY	CURRENCY_PAIR
LTLTRY=X	LTL/TRY	CCY	CURRENCY_PAIR
LTLINR=X	LTL/INR	CCY	CURRENCY_PAIR
LKRNZD=X	LKR/NZD	CCY	CURRENCY_PAIR
LVLEGP=X	LVL/EGP	CCY	CURRENCY_PAIR
LVLAUD=X	LVL/AUD	CCY	CURRENCY_PAIR
LKRTND=X	LKR/TND	CCY	CURRENCY_PAIR
LKRSAR=X	LKR/SAR	CCY	CURRENCY_PAIR
LTLISK=X	LTL/ISK	CCY	CURRENCY_PAIR
LTLCNY=X	LTL/CNY	CCY	CURRENCY_PAIR
LSLGBP=X	LSL/GBP	CCY	CURRENCY_PAIR
LTLHKD=X	LTL/HKD	CCY	CURRENCY_PAIR
LVLRUB=X	LVL/RUB	CCY	CURRENCY_PAIR
LKRZAR=X	LKR/ZAR	CCY	CURRENCY_PAIR
LTLRON=X	LTL/RON	CCY	CURRENCY_PAIR
LTLQAR=X	LTL/QAR	CCY	CURRENCY_PAIR
LVLJPY=X	LVL/JPY	CCY	CURRENCY_PAIR
LBP=X	USD/LBP	CCY	CURRENCY_PAIR
LKRISK=X	LKR/ISK	CCY	CURRENCY_PAIR
LKRTRY=X	LKR/TRY	CCY	CURRENCY_PAIR
LTLBRL=X	LTL/BRL	CCY	CURRENCY_PAIR
LTLAUD=X	LTL/AUD	CCY	CURRENCY_PAIR
LVLILS=X	LVL/ILS	CCY	CURRENCY_PAIR
LVLTND=X	LVL/TND	CCY	CURRENCY_PAIR
LKRTWD=X	LKR/TWD	CCY	CURRENCY_PAIR
LKRPLN=X	LKR/PLN	CCY	CURRENCY_PAIR
LKRLTL=X	LKR/LTL	CCY	CURRENCY_PAIR
LYDCHF=X	LYD/CHF	CCY	CURRENCY_PAIR
LVLMXN=X	LVL/MXN	CCY	CURRENCY_PAIR
LKRAED=X	LKR/AED	CCY	CURRENCY_PAIR
LKRGBP=X	LKR/GBP	CCY	CURRENCY_PAIR
LTLIDR=X	LTL/IDR	CCY	CURRENCY_PAIR
LTLTND=X	LTL/TND	CCY	CURRENCY_PAIR
LTLEGP=X	LTL/EGP	CCY	CURRENCY_PAIR
LYDUSD=X	LYD/USD	CCY	CURRENCY_PAIR
LKRMAD=X	LKR/MAD	CCY	CURRENCY_PAIR
LYDXDR=X	LYD/XDR	CCY	CURRENCY_PAIR
LVLMAD=X	LVL/MAD	CCY	CURRENCY_PAIR
LVLNZD=X	LVL/NZD	CCY	CURRENCY_PAIR
LTLNOK=X	LTL/NOK	CCY	CURRENCY_PAIR
LKRCHF=X	LKR/CHF	CCY	CURRENCY_PAIR
LKRRUB=X	LKR/RUB	CCY	CURRENCY_PAIR
LVLKWD=X	LVL/KWD	CCY	CURRENCY_PAIR
LVLOMR=X	LVL/OMR	CCY	CURRENCY_PAIR
LVLEUR=X	LVL/EUR	CCY	CURRENCY_PAIR
LVLSEK=X	LVL/SEK	CCY	CURRENCY_PAIR
LTLSAR=X	LTL/SAR	CCY	CURRENCY_PAIR
LVLHKD=X	LVL/HKD	CCY	CURRENCY_PAIR
LKRCAD=X	LKR/CAD	CCY	CURRENCY_PAIR
LSLUSD=X	LSL/USD	CCY	CURRENCY_PAIR
LTLOMR=X	LTL/OMR	CCY	CURRENCY_PAIR
LTLMXN=X	LTL/MXN	CCY	CURRENCY_PAIR
LKRKRW=X	LKR/KRW	CCY	CURRENCY_PAIR
LTLTWD=X	LTL/TWD	CCY	CURRENCY_PAIR
LVLLTL=X	LVL/LTL	CCY	CURRENCY_PAIR
LAK=X	USD/LAK	CCY	CURRENCY_PAIR
LKRILS=X	LKR/ILS	CCY	CURRENCY_PAIR
LTLKWD=X	LTL/KWD	CCY	CURRENCY_PAIR
LKRIDR=X	LKR/IDR	CCY	CURRENCY_PAIR
LVLJOD=X	LVL/JOD	CCY	CURRENCY_PAIR
LVLLKR=X	LVL/LKR	CCY	CURRENCY_PAIR
LTL=X	USD/LTL	CCY	CURRENCY_PAIR
LTLILS=X	LTL/ILS	CCY	CURRENCY_PAIR
LTLHUF=X	LTL/HUF	CCY	CURRENCY_PAIR
LKRMXN=X	LKR/MXN	CCY	CURRENCY_PAIR
LTLJPY=X	LTL/JPY	CCY	CURRENCY_PAIR
LKRINR=X	LKR/INR	CCY	CURRENCY_PAIR
LVLISK=X	LVL/ISK	CCY	CURRENCY_PAIR
LVLCNY=X	LVL/CNY	CCY	CURRENCY_PAIR
LTLCHF=X	LTL/CHF	CCY	CURRENCY_PAIR
LTLZAR=X	LTL/ZAR	CCY	CURRENCY_PAIR
LKRKES=X	LKR/KES	CCY	CURRENCY_PAIR
LKREUR=X	LKR/EUR	CCY	CURRENCY_PAIR
LVLUSD=X	LVL/USD	CCY	CURRENCY_PAIR
LTLEUR=X	LTL/EUR	CCY	CURRENCY_PAIR
LVLMUR=X	LVL/MUR	CCY	CURRENCY_PAIR
LKRDKK=X	LKR/DKK	CCY	CURRENCY_PAIR
LKRSEK=X	LKR/SEK	CCY	CURRENCY_PAIR
LKREGP=X	LKR/EGP	CCY	CURRENCY_PAIR
LKRPHP=X	LKR/PHP	CCY	CURRENCY_PAIR
LVLINR=X	LVL/INR	CCY	CURRENCY_PAIR
LTLUSD=X	LTL/USD	CCY	CURRENCY_PAIR
LTLDKK=X	LTL/DKK	CCY	CURRENCY_PAIR
LTLMUR=X	LTL/MUR	CCY	CURRENCY_PAIR
LTLCAD=X	LTL/CAD	CCY	CURRENCY_PAIR
LKRSGD=X	LKR/SGD	CCY	CURRENCY_PAIR
LYD=X	USD/LYD	CCY	CURRENCY_PAIR
LRDUSD=X	LRD/USD	CCY	CURRENCY_PAIR
LTLNZD=X	LTL/NZD	CCY	CURRENCY_PAIR
LTLHRK=X	LTL/HRK	CCY	CURRENCY_PAIR
LVLTWD=X	LVL/TWD	CCY	CURRENCY_PAIR
MYRHKD=X	MYR/HKD	CCY	CURRENCY_PAIR
MXNJPY=X	MXN/JPY	CCY	CURRENCY_PAIR
MYRXDR=X	MYR/XDR	CCY	CURRENCY_PAIR
MYRUSD=X	MYR/USD	CCY	CURRENCY_PAIR
MYRTND=X	MYR/TND	CCY	CURRENCY_PAIR
MYRPHP=X	MYR/PHP	CCY	CURRENCY_PAIR
MYRMAD=X	MYR/MAD	CCY	CURRENCY_PAIR
MYRKWD=X	MYR/KWD	CCY	CURRENCY_PAIR
MYRAUD=X	MYR/AUD	CCY	CURRENCY_PAIR
MYRARS=X	MYR/ARS	CCY	CURRENCY_PAIR
MYR=X	USD/MYR	CCY	CURRENCY_PAIR
MXNXDR=X	MXN/XDR	CCY	CURRENCY_PAIR
MXNUYU=X	MXN/UYU	CCY	CURRENCY_PAIR
MXNSAR=X	MXN/SAR	CCY	CURRENCY_PAIR
MXNPYG=X	MXN/PYG	CCY	CURRENCY_PAIR
MXNPEN=X	MXN/PEN	CCY	CURRENCY_PAIR
MXNLTL=X	MXN/LTL	CCY	CURRENCY_PAIR
MXNKES=X	MXN/KES	CCY	CURRENCY_PAIR
MURMXN=X	MUR/MXN	CCY	CURRENCY_PAIR
MURKES=X	MUR/KES	CCY	CURRENCY_PAIR
MURILS=X	MUR/ILS	CCY	CURRENCY_PAIR
MUREUR=X	MUR/EUR	CCY	CURRENCY_PAIR
MOPUSD=X	MOP/USD	CCY	CURRENCY_PAIR
MOPJPY=X	MOP/JPY	CCY	CURRENCY_PAIR
MADILS=X	MAD/ILS	CCY	CURRENCY_PAIR
MADCNY=X	MAD/CNY	CCY	CURRENCY_PAIR
MADAED=X	MAD/AED	CCY	CURRENCY_PAIR
MADTND=X	MAD/TND	CCY	CURRENCY_PAIR
MVRCHF=X	MVR/CHF	CCY	CURRENCY_PAIR
MVREUR=X	MVR/EUR	CCY	CURRENCY_PAIR
MURLKR=X	MUR/LKR	CCY	CURRENCY_PAIR
29134347=X			CURRENCY_PAIR
MXNAED=X	MXN/AED	CCY	CURRENCY_PAIR
MURINR=X	MUR/INR	CCY	CURRENCY_PAIR
MDLCHF=X	MDL/CHF	CCY	CURRENCY_PAIR
MXNUSD=X	MXN/USD	CCY	CURRENCY_PAIR
MURHUF=X	MUR/HUF	CCY	CURRENCY_PAIR
MXNBRL=X	MXN/BRL	CCY	CURRENCY_PAIR
MURSGD=X	MUR/SGD	CCY	CURRENCY_PAIR
MXNCHF=X	MXN/CHF	CCY	CURRENCY_PAIR
MXNBOB=X	MXN/BOB	CCY	CURRENCY_PAIR
MURCZK=X	MUR/CZK	CCY	CURRENCY_PAIR
MADZAR=X	MAD/ZAR	CCY	CURRENCY_PAIR
MXNHKD=X	MXN/HKD	CCY	CURRENCY_PAIR
MYRSGD=X	MYR/SGD	CCY	CURRENCY_PAIR
MOPGBP=X	MOP/GBP	CCY	CURRENCY_PAIR
MADQAR=X	MAD/QAR	CCY	CURRENCY_PAIR
MKDJPY=X	MKD/JPY	CCY	CURRENCY_PAIR
MOP=X	USD/MOP	CCY	CURRENCY_PAIR
MROMAD=X	MRO/MAD	CCY	CURRENCY_PAIR
MRO=X	USD/MRO	CCY	CURRENCY_PAIR
MZNJPY=X	MZN/JPY	CCY	CURRENCY_PAIR
MYRCOP=X	MYR/COP	CCY	CURRENCY_PAIR
MURRUB=X	MUR/RUB	CCY	CURRENCY_PAIR
MURCAD=X	MUR/CAD	CCY	CURRENCY_PAIR
MADJPY=X	MAD/JPY	CCY	CURRENCY_PAIR
MXNCAD=X	MXN/CAD	CCY	CURRENCY_PAIR
MYRBRL=X	MYR/BRL	CCY	CURRENCY_PAIR
MAD=X	USD/MAD	CCY	CURRENCY_PAIR
MADIDR=X	MAD/IDR	CCY	CURRENCY_PAIR
MADEGP=X	MAD/EGP	CCY	CURRENCY_PAIR
MYRBMD=X	MYR/BMD	CCY	CURRENCY_PAIR
MWK=X	USD/MWK	CCY	CURRENCY_PAIR
MYRVEF=X	MYR/VEF	CCY	CURRENCY_PAIR
MXNQAR=X	MXN/QAR	CCY	CURRENCY_PAIR
MURCNY=X	MUR/CNY	CCY	CURRENCY_PAIR
MADMXN=X	MAD/MXN	CCY	CURRENCY_PAIR
MADPHP=X	MAD/PHP	CCY	CURRENCY_PAIR
MXNKWD=X	MXN/KWD	CCY	CURRENCY_PAIR
MKD=X	USD/MKD	CCY	CURRENCY_PAIR
MURPHP=X	MUR/PHP	CCY	CURRENCY_PAIR
MADTWD=X	MAD/TWD	CCY	CURRENCY_PAIR
MYRCHF=X	MYR/CHF	CCY	CURRENCY_PAIR
MADCAD=X	MAD/CAD	CCY	CURRENCY_PAIR
MADLVL=X	MAD/LVL	CCY	CURRENCY_PAIR
MURPLN=X	MUR/PLN	CCY	CURRENCY_PAIR
MNT=X	USD/MNT	CCY	CURRENCY_PAIR
MADLTL=X	MAD/LTL	CCY	CURRENCY_PAIR
MOPCAD=X	MOP/CAD	CCY	CURRENCY_PAIR
MADRUB=X	MAD/RUB	CCY	CURRENCY_PAIR
MXNTND=X	MXN/TND	CCY	CURRENCY_PAIR
MYRCAD=X	MYR/CAD	CCY	CURRENCY_PAIR
MADGBP=X	MAD/GBP	CCY	CURRENCY_PAIR
MURISK=X	MUR/ISK	CCY	CURRENCY_PAIR
MXNTWD=X	MXN/TWD	CCY	CURRENCY_PAIR
MXNEUR=X	MXN/EUR	CCY	CURRENCY_PAIR
MVRGBP=X	MVR/GBP	CCY	CURRENCY_PAIR
MXNLVL=X	MXN/LVL	CCY	CURRENCY_PAIR
MOPCHF=X	MOP/CHF	CCY	CURRENCY_PAIR
MURSAR=X	MUR/SAR	CCY	CURRENCY_PAIR
MDLUSD=X	MDL/USD	CCY	CURRENCY_PAIR
MADHUF=X	MAD/HUF	CCY	CURRENCY_PAIR
MYREUR=X	MYR/EUR	CCY	CURRENCY_PAIR
MYRLBP=X	MYR/LBP	CCY	CURRENCY_PAIR
MURIDR=X	MUR/IDR	CCY	CURRENCY_PAIR
MURDKK=X	MUR/DKK	CCY	CURRENCY_PAIR
MYRIDR=X	MYR/IDR	CCY	CURRENCY_PAIR
MURHKD=X	MUR/HKD	CCY	CURRENCY_PAIR
MYRILS=X	MYR/ILS	CCY	CURRENCY_PAIR
MOPEUR=X	MOP/EUR	CCY	CURRENCY_PAIR
MYRAED=X	MYR/AED	CCY	CURRENCY_PAIR
MADUSD=X	MAD/USD	CCY	CURRENCY_PAIR
MADJOD=X	MAD/JOD	CCY	CURRENCY_PAIR
MURTWD=X	MUR/TWD	CCY	CURRENCY_PAIR
MYRZAR=X	MYR/ZAR	CCY	CURRENCY_PAIR
MURTND=X	MUR/TND	CCY	CURRENCY_PAIR
MXNOMR=X	MXN/OMR	CCY	CURRENCY_PAIR
MOPAUD=X	MOP/AUD	CCY	CURRENCY_PAIR
MXNINR=X	MXN/INR	CCY	CURRENCY_PAIR
MADKWD=X	MAD/KWD	CCY	CURRENCY_PAIR
MURKWD=X	MUR/KWD	CCY	CURRENCY_PAIR
MZNEUR=X	MZN/EUR	CCY	CURRENCY_PAIR
MURAED=X	MUR/AED	CCY	CURRENCY_PAIR
MXNGBP=X	MXN/GBP	CCY	CURRENCY_PAIR
MXNJOD=X	MXN/JOD	CCY	CURRENCY_PAIR
MXNDKK=X	MXN/DKK	CCY	CURRENCY_PAIR
MYRCLP=X	MYR/CLP	CCY	CURRENCY_PAIR
MADEUR=X	MAD/EUR	CCY	CURRENCY_PAIR
MDLGBP=X	MDL/GBP	CCY	CURRENCY_PAIR
MURUSD=X	MUR/USD	CCY	CURRENCY_PAIR
MURMAD=X	MUR/MAD	CCY	CURRENCY_PAIR
MYRINR=X	MYR/INR	CCY	CURRENCY_PAIR
MVR=X	USD/MVR	CCY	CURRENCY_PAIR
MURNZD=X	MUR/NZD	CCY	CURRENCY_PAIR
MXNAUD=X	MXN/AUD	CCY	CURRENCY_PAIR
MXNCLP=X	MXN/CLP	CCY	CURRENCY_PAIR
MYRJPY=X	MYR/JPY	CCY	CURRENCY_PAIR
MURZAR=X	MUR/ZAR	CCY	CURRENCY_PAIR
MADNZD=X	MAD/NZD	CCY	CURRENCY_PAIR
MVRUSD=X	MVR/USD	CCY	CURRENCY_PAIR
MXNPHP=X	MXN/PHP	CCY	CURRENCY_PAIR
MZNCHF=X	MZN/CHF	CCY	CURRENCY_PAIR
MURSEK=X	MUR/SEK	CCY	CURRENCY_PAIR
MURJPY=X	MUR/JPY	CCY	CURRENCY_PAIR
MXNSGD=X	MXN/SGD	CCY	CURRENCY_PAIR
MXNZAR=X	MXN/ZAR	CCY	CURRENCY_PAIR
MXNIDR=X	MXN/IDR	CCY	CURRENCY_PAIR
MYRMXN=X	MYR/MXN	CCY	CURRENCY_PAIR
MXNMUR=X	MXN/MUR	CCY	CURRENCY_PAIR
MYRCNH=X	MYR/CNH	CCY	CURRENCY_PAIR
MURLVL=X	MUR/LVL	CCY	CURRENCY_PAIR
MURLTL=X	MUR/LTL	CCY	CURRENCY_PAIR
MOPSGD=X	MOP/SGD	CCY	CURRENCY_PAIR
MYRRUB=X	MYR/RUB	CCY	CURRENCY_PAIR
MURTRY=X	MUR/TRY	CCY	CURRENCY_PAIR
MUR=X	USD/MUR	CCY	CURRENCY_PAIR
MURJOD=X	MUR/JOD	CCY	CURRENCY_PAIR
MYRNZD=X	MYR/NZD	CCY	CURRENCY_PAIR
MXNHUF=X	MXN/HUF	CCY	CURRENCY_PAIR
MUREGP=X	MUR/EGP	CCY	CURRENCY_PAIR
MOPHKD=X	MOP/HKD	CCY	CURRENCY_PAIR
MURCHF=X	MUR/CHF	CCY	CURRENCY_PAIR
MXNMYR=X	MXN/MYR	CCY	CURRENCY_PAIR
MADSEK=X	MAD/SEK	CCY	CURRENCY_PAIR
OMA.PA	OMA.PA	PAR	CURRENCY_PAIR
MZN=X	USD/MZN	CCY	CURRENCY_PAIR
MYRKRW=X	MYR/KRW	CCY	CURRENCY_PAIR
MMK=X	USD/MMK	CCY	CURRENCY_PAIR
MADCHF=X	MAD/CHF	CCY	CURRENCY_PAIR
MYRNGN=X	MYR/NGN	CCY	CURRENCY_PAIR
MXNEGP=X	MXN/EGP	CCY	CURRENCY_PAIR
MADDKK=X	MAD/DKK	CCY	CURRENCY_PAIR
MXNNZD=X	MXN/NZD	CCY	CURRENCY_PAIR
MADHKD=X	MAD/HKD	CCY	CURRENCY_PAIR
MDL=X	USD/MDL	CCY	CURRENCY_PAIR
MXNVEF=X	MXN/VEF	CCY	CURRENCY_PAIR
MXNSEK=X	MXN/SEK	CCY	CURRENCY_PAIR
MADINR=X	MAD/INR	CCY	CURRENCY_PAIR
MXNTHB=X	MXN/THB	CCY	CURRENCY_PAIR
MURQAR=X	MUR/QAR	CCY	CURRENCY_PAIR
MADKES=X	MAD/KES	CCY	CURRENCY_PAIR
MURNOK=X	MUR/NOK	CCY	CURRENCY_PAIR
MADKRW=X	MAD/KRW	CCY	CURRENCY_PAIR
MURAUD=X	MUR/AUD	CCY	CURRENCY_PAIR
MXV=X	USD/MXV	CCY	CURRENCY_PAIR
MADPLN=X	MAD/PLN	CCY	CURRENCY_PAIR
MADMUR=X	MAD/MUR	CCY	CURRENCY_PAIR
MUROMR=X	MUR/OMR	CCY	CURRENCY_PAIR
MYROMR=X	MYR/OMR	CCY	CURRENCY_PAIR
MADSAR=X	MAD/SAR	CCY	CURRENCY_PAIR
29134348=X			CURRENCY_PAIR
MXNLKR=X	MXN/LKR	CCY	CURRENCY_PAIR
MKDEUR=X	MKD/EUR	CCY	CURRENCY_PAIR
MADOMR=X	MAD/OMR	CCY	CURRENCY_PAIR
MXNCZK=X	MXN/CZK	CCY	CURRENCY_PAIR
MXNILS=X	MXN/ILS	CCY	CURRENCY_PAIR
MYRBHD=X	MYR/BHD	CCY	CURRENCY_PAIR
MYRBOB=X	MYR/BOB	CCY	CURRENCY_PAIR
MGA=X	USD/MGA	CCY	CURRENCY_PAIR
MURGBP=X	MUR/GBP	CCY	CURRENCY_PAIR
MYRUYU=X	MYR/UYU	CCY	CURRENCY_PAIR
MYRZWL=X	MYR/ZWL	CCY	CURRENCY_PAIR
MYRTHB=X	MYR/THB	CCY	CURRENCY_PAIR
MURXDR=X	MUR/XDR	CCY	CURRENCY_PAIR
MKDGBP=X	MKD/GBP	CCY	CURRENCY_PAIR
MYRPKR=X	MYR/PKR	CCY	CURRENCY_PAIR
MXNTRY=X	MXN/TRY	CCY	CURRENCY_PAIR
MA.PA			CURRENCY_PAIR
MXNKRW=X	MXN/KRW	CCY	CURRENCY_PAIR
MXNPLN=X	MXN/PLN	CCY	CURRENCY_PAIR
MURKRW=X	MUR/KRW	CCY	CURRENCY_PAIR
MZNCAD=X	MZN/CAD	CCY	CURRENCY_PAIR
MYRPEN=X	MYR/PEN	CCY	CURRENCY_PAIR
MXNRUB=X	MXN/RUB	CCY	CURRENCY_PAIR
MADAUD=X	MAD/AUD	CCY	CURRENCY_PAIR
MYRDKK=X	MYR/DKK	CCY	CURRENCY_PAIR
MYREGP=X	MYR/EGP	CCY	CURRENCY_PAIR
MADTRY=X	MAD/TRY	CCY	CURRENCY_PAIR
MXNARS=X	MXN/ARS	CCY	CURRENCY_PAIR
MXNNOK=X	MXN/NOK	CCY	CURRENCY_PAIR
MYRTRY=X	MYR/TRY	CCY	CURRENCY_PAIR
MXNCOP=X	MXN/COP	CCY	CURRENCY_PAIR
MADNOK=X	MAD/NOK	CCY	CURRENCY_PAIR
MADCZK=X	MAD/CZK	CCY	CURRENCY_PAIR
MZNUSD=X	MZN/USD	CCY	CURRENCY_PAIR
MXNMAD=X	MXN/MAD	CCY	CURRENCY_PAIR
MADLKR=X	MAD/LKR	CCY	CURRENCY_PAIR
MXN=X	USD/MXN	CCY	CURRENCY_PAIR
MYRJOD=X	MYR/JOD	CCY	CURRENCY_PAIR
MADSGD=X	MAD/SGD	CCY	CURRENCY_PAIR
MXNISK=X	MXN/ISK	CCY	CURRENCY_PAIR
MADTHB=X	MAD/THB	CCY	CURRENCY_PAIR
MYRSAR=X	MYR/SAR	CCY	CURRENCY_PAIR
MKDUSD=X	MKD/USD	CCY	CURRENCY_PAIR
MYRTWD=X	MYR/TWD	CCY	CURRENCY_PAIR
MXVUSD=X	MXV/USD	CCY	CURRENCY_PAIR
MYRMUR=X	MYR/MUR	CCY	CURRENCY_PAIR
MADISK=X	MAD/ISK	CCY	CURRENCY_PAIR
MXNCNY=X	MXN/CNY	CCY	CURRENCY_PAIR
MYRCNY=X	MYR/CNY	CCY	CURRENCY_PAIR
MZNGBP=X	MZN/GBP	CCY	CURRENCY_PAIR
MXVMXN=X	MXV/MXN	CCY	CURRENCY_PAIR
MDLEUR=X	MDL/EUR	CCY	CURRENCY_PAIR
MURTHB=X	MUR/THB	CCY	CURRENCY_PAIR
NZDUSD=X	NZD/USD	CCY	CURRENCY_PAIR
NZDKRW=X	NZD/KRW	CCY	CURRENCY_PAIR
NZDKES=X	NZD/KES	CCY	CURRENCY_PAIR
NZDEGP=X	NZD/EGP	CCY	CURRENCY_PAIR
NZDCZK=X	NZD/CZK	CCY	CURRENCY_PAIR
NZDCHF=X	NZD/CHF	CCY	CURRENCY_PAIR
NPRUSD=X	NPR/USD	CCY	CURRENCY_PAIR
NPRGBP=X	NPR/GBP	CCY	CURRENCY_PAIR
NOKTND=X	NOK/TND	CCY	CURRENCY_PAIR
NOKMAD=X	NOK/MAD	CCY	CURRENCY_PAIR
NOKLTL=X	NOK/LTL	CCY	CURRENCY_PAIR
NOKIDR=X	NOK/IDR	CCY	CURRENCY_PAIR
NOKEUR=X	NOK/EUR	CCY	CURRENCY_PAIR
NOKEGP=X	NOK/EGP	CCY	CURRENCY_PAIR
NOKCNH=X	NOK/CNH	CCY	CURRENCY_PAIR
NOKCHF=X	NOK/CHF	CCY	CURRENCY_PAIR
NOKBAM=X	NOK/BAM	CCY	CURRENCY_PAIR
NOKAED=X	NOK/AED	CCY	CURRENCY_PAIR
NOK=X	USD/NOK	CCY	CURRENCY_PAIR
NIOUSD=X	NIO/USD	CCY	CURRENCY_PAIR
NADDKK=X	NAD/DKK	CCY	CURRENCY_PAIR
NZDMXN=X	NZD/MXN	CCY	CURRENCY_PAIR
NOKCLP=X	NOK/CLP	CCY	CURRENCY_PAIR
NZDHKD=X	NZD/HKD	CCY	CURRENCY_PAIR
NPRCHF=X	NPR/CHF	CCY	CURRENCY_PAIR
NIOGBP=X	NIO/GBP	CCY	CURRENCY_PAIR
NZDTWD=X	NZD/TWD	CCY	CURRENCY_PAIR
NGN=X	USD/NGN	CCY	CURRENCY_PAIR
29134349=X			CURRENCY_PAIR
NOKRSD=X	NOK/RSD	CCY	CURRENCY_PAIR
NIOCHF=X	NIO/CHF	CCY	CURRENCY_PAIR
NPRXDR=X	NPR/XDR	CCY	CURRENCY_PAIR
NOKSAR=X	NOK/SAR	CCY	CURRENCY_PAIR
NOKXDR=X	NOK/XDR	CCY	CURRENCY_PAIR
NADGBP=X	NAD/GBP	CCY	CURRENCY_PAIR
NOKISK=X	NOK/ISK	CCY	CURRENCY_PAIR
NZDCNY=X	NZD/CNY	CCY	CURRENCY_PAIR
NOKDKK=X	NOK/DKK	CCY	CURRENCY_PAIR
NZDEUR=X	NZD/EUR	CCY	CURRENCY_PAIR
NZDSGD=X	NZD/SGD	CCY	CURRENCY_PAIR
NOKPKR=X	NOK/PKR	CCY	CURRENCY_PAIR
NZDMYR=X	NZD/MYR	CCY	CURRENCY_PAIR
NIO=X	USD/NIO	CCY	CURRENCY_PAIR
NZDINR=X	NZD/INR	CCY	CURRENCY_PAIR
NOKJOD=X	NOK/JOD	CCY	CURRENCY_PAIR
NOKCNY=X	NOK/CNY	CCY	CURRENCY_PAIR
NOKOMR=X	NOK/OMR	CCY	CURRENCY_PAIR
NOKBRL=X	NOK/BRL	CCY	CURRENCY_PAIR
NZDHRK=X	NZD/HRK	CCY	CURRENCY_PAIR
NZDOMR=X	NZD/OMR	CCY	CURRENCY_PAIR
NADUSD=X	NAD/USD	CCY	CURRENCY_PAIR
NADZAR=X	NAD/ZAR	CCY	CURRENCY_PAIR
NZDLKR=X	NZD/LKR	CCY	CURRENCY_PAIR
NZDXDR=X	NZD/XDR	CCY	CURRENCY_PAIR
NZDMUR=X	NZD/MUR	CCY	CURRENCY_PAIR
NOKKWD=X	NOK/KWD	CCY	CURRENCY_PAIR
NPR=X	USD/NPR	CCY	CURRENCY_PAIR
NADCHF=X	NAD/CHF	CCY	CURRENCY_PAIR
NZDAUD=X	NZD/AUD	CCY	CURRENCY_PAIR
NADEUR=X	NAD/EUR	CCY	CURRENCY_PAIR
NOKKRW=X	NOK/KRW	CCY	CURRENCY_PAIR
NZDFJD=X	NZD/FJD	CCY	CURRENCY_PAIR
NOKPLN=X	NOK/PLN	CCY	CURRENCY_PAIR
29134350=X			CURRENCY_PAIR
NZDBRL=X	NZD/BRL	CCY	CURRENCY_PAIR
NOKRON=X	NOK/RON	CCY	CURRENCY_PAIR
NGNDKK=X	NGN/DKK	CCY	CURRENCY_PAIR
NZDPKR=X	NZD/PKR	CCY	CURRENCY_PAIR
NZDILS=X	NZD/ILS	CCY	CURRENCY_PAIR
NOKTHB=X	NOK/THB	CCY	CURRENCY_PAIR
NZDJOD=X	NZD/JOD	CCY	CURRENCY_PAIR
NOKCZK=X	NOK/CZK	CCY	CURRENCY_PAIR
NZDCNH=X	NZD/CNH	CCY	CURRENCY_PAIR
NOKINR=X	NOK/INR	CCY	CURRENCY_PAIR
NOKHKD=X	NOK/HKD	CCY	CURRENCY_PAIR
NIOEUR=X	NIO/EUR	CCY	CURRENCY_PAIR
NZDLTL=X	NZD/LTL	CCY	CURRENCY_PAIR
NZDPGK=X	NZD/PGK	CCY	CURRENCY_PAIR
NZDQAR=X	NZD/QAR	CCY	CURRENCY_PAIR
NOKUSD=X	NOK/USD	CCY	CURRENCY_PAIR
NZDISK=X	NZD/ISK	CCY	CURRENCY_PAIR
NZDDKK=X	NZD/DKK	CCY	CURRENCY_PAIR
NOKRUB=X	NOK/RUB	CCY	CURRENCY_PAIR
NOKKES=X	NOK/KES	CCY	CURRENCY_PAIR
NZDIDR=X	NZD/IDR	CCY	CURRENCY_PAIR
NZDHUF=X	NZD/HUF	CCY	CURRENCY_PAIR
NAD=X	USD/NAD	CCY	CURRENCY_PAIR
NOKTWD=X	NOK/TWD	CCY	CURRENCY_PAIR
NOKMYR=X	NOK/MYR	CCY	CURRENCY_PAIR
NZDKWD=X	NZD/KWD	CCY	CURRENCY_PAIR
NPREUR=X	NPR/EUR	CCY	CURRENCY_PAIR
29134351=X			CURRENCY_PAIR
NOKLKR=X	NOK/LKR	CCY	CURRENCY_PAIR
NZDPLN=X	NZD/PLN	CCY	CURRENCY_PAIR
NZD=X	USD/NZD	CCY	CURRENCY_PAIR
NZDMAD=X	NZD/MAD	CCY	CURRENCY_PAIR
NGNCHF=X	NGN/CHF	CCY	CURRENCY_PAIR
NZDAED=X	NZD/AED	CCY	CURRENCY_PAIR
NGNTHB=X	NGN/THB	CCY	CURRENCY_PAIR
NZDCLP=X	NZD/CLP	CCY	CURRENCY_PAIR
XAG=X	SILVER 1 OZ 999 NY	CCY	CURRENCY_PAIR
NOKHUF=X	NOK/HUF	CCY	CURRENCY_PAIR
NZDRUB=X	NZD/RUB	CCY	CURRENCY_PAIR
NGNZAR=X	NGN/ZAR	CCY	CURRENCY_PAIR
NGNUSD=X	NGN/USD	CCY	CURRENCY_PAIR
NZDRSD=X	NZD/RSD	CCY	CURRENCY_PAIR
NOKILS=X	NOK/ILS	CCY	CURRENCY_PAIR
NZDTHB=X	NZD/THB	CCY	CURRENCY_PAIR
NOKQAR=X	NOK/QAR	CCY	CURRENCY_PAIR
NZDPHP=X	NZD/PHP	CCY	CURRENCY_PAIR
NZDSAR=X	NZD/SAR	CCY	CURRENCY_PAIR
NZDTRY=X	NZD/TRY	CCY	CURRENCY_PAIR
NOKPHP=X	NOK/PHP	CCY	CURRENCY_PAIR
NOKSEK=X	NOK/SEK	CCY	CURRENCY_PAIR
NZDTND=X	NZD/TND	CCY	CURRENCY_PAIR
NOKMXN=X	NOK/MXN	CCY	CURRENCY_PAIR
NOKSGD=X	NOK/SGD	CCY	CURRENCY_PAIR
NOKMUR=X	NOK/MUR	CCY	CURRENCY_PAIR
NZDLVL=X	NZD/LVL	CCY	CURRENCY_PAIR
NOKTRY=X	NOK/TRY	CCY	CURRENCY_PAIR
NZDUAH=X	NZD/UAH	CCY	CURRENCY_PAIR
OMRSEK=X	OMR/SEK	CCY	CURRENCY_PAIR
OMRPLN=X	OMR/PLN	CCY	CURRENCY_PAIR
OMRKES=X	OMR/KES	CCY	CURRENCY_PAIR
OMRISK=X	OMR/ISK	CCY	CURRENCY_PAIR
OMRILS=X	OMR/ILS	CCY	CURRENCY_PAIR
OMRHUF=X	OMR/HUF	CCY	CURRENCY_PAIR
OMRDKK=X	OMR/DKK	CCY	CURRENCY_PAIR
OMRCAD=X	OMR/CAD	CCY	CURRENCY_PAIR
OMRPHP=X	OMR/PHP	CCY	CURRENCY_PAIR
OMRTRY=X	OMR/TRY	CCY	CURRENCY_PAIR
OMRAUD=X	OMR/AUD	CCY	CURRENCY_PAIR
OMRKWD=X	OMR/KWD	CCY	CURRENCY_PAIR
274720=X			CURRENCY_PAIR
OMREUR=X	OMR/EUR	CCY	CURRENCY_PAIR
OMREGP=X	OMR/EGP	CCY	CURRENCY_PAIR
OMRHKD=X	OMR/HKD	CCY	CURRENCY_PAIR
OMRJOD=X	OMR/JOD	CCY	CURRENCY_PAIR
OMRINR=X	OMR/INR	CCY	CURRENCY_PAIR
OMRSGD=X	OMR/SGD	CCY	CURRENCY_PAIR
OMRCZK=X	OMR/CZK	CCY	CURRENCY_PAIR
OMRXDR=X	OMR/XDR	CCY	CURRENCY_PAIR
OMRTHB=X	OMR/THB	CCY	CURRENCY_PAIR
OMRSAR=X	OMR/SAR	CCY	CURRENCY_PAIR
OMRNOK=X	OMR/NOK	CCY	CURRENCY_PAIR
OMRIDR=X	OMR/IDR	CCY	CURRENCY_PAIR
OSFX.EX			CURRENCY_PAIR
OMRTND=X	OMR/TND	CCY	CURRENCY_PAIR
OMRMUR=X	OMR/MUR	CCY	CURRENCY_PAIR
OMRLTL=X	OMR/LTL	CCY	CURRENCY_PAIR
OMRPKR=X	OMR/PKR	CCY	CURRENCY_PAIR
OMRBHD=X	OMR/BHD	CCY	CURRENCY_PAIR
OMRAED=X	OMR/AED	CCY	CURRENCY_PAIR
OMRZAR=X	OMR/ZAR	CCY	CURRENCY_PAIR
OMRKRW=X	OMR/KRW	CCY	CURRENCY_PAIR
OMRNZD=X	OMR/NZD	CCY	CURRENCY_PAIR
OMRJPY=X	OMR/JPY	CCY	CURRENCY_PAIR
OMRCNY=X	OMR/CNY	CCY	CURRENCY_PAIR
OMRRUB=X	OMR/RUB	CCY	CURRENCY_PAIR
OMRMXN=X	OMR/MXN	CCY	CURRENCY_PAIR
OMRUSD=X	OMR/USD	CCY	CURRENCY_PAIR
OMR=X	USD/OMR	CCY	CURRENCY_PAIR
OMRLVL=X	OMR/LVL	CCY	CURRENCY_PAIR
OMRTWD=X	OMR/TWD	CCY	CURRENCY_PAIR
OMRLKR=X	OMR/LKR	CCY	CURRENCY_PAIR
OCUF.EX			CURRENCY_PAIR
OMRGBP=X	OMR/GBP	CCY	CURRENCY_PAIR
OMRCHF=X	OMR/CHF	CCY	CURRENCY_PAIR
OMRMAD=X	OMR/MAD	CCY	CURRENCY_PAIR
OMRQAR=X	OMR/QAR	CCY	CURRENCY_PAIR
PLNTRY=X	PLN/TRY	CCY	CURRENCY_PAIR
PLNSAR=X	PLN/SAR	CCY	CURRENCY_PAIR
PLNHUF=X	PLN/HUF	CCY	CURRENCY_PAIR
PKRZAR=X	PKR/ZAR	CCY	CURRENCY_PAIR
PKRNOK=X	PKR/NOK	CCY	CURRENCY_PAIR
PKRCAD=X	PKR/CAD	CCY	CURRENCY_PAIR
PHPISK=X	PHP/ISK	CCY	CURRENCY_PAIR
PHPILS=X	PHP/ILS	CCY	CURRENCY_PAIR
PHP=X	USD/PHP	CCY	CURRENCY_PAIR
PLNLBP=X	PLN/LBP	CCY	CURRENCY_PAIR
287635=X			CURRENCY_PAIR
PENBOB=X	PEN/BOB	CCY	CURRENCY_PAIR
PLNUYU=X	PLN/UYU	CCY	CURRENCY_PAIR
PGKUSD=X	PGK/USD	CCY	CURRENCY_PAIR
PENBRL=X	PEN/BRL	CCY	CURRENCY_PAIR
29134353=X			CURRENCY_PAIR
PLNVEF=X	PLN/VEF	CCY	CURRENCY_PAIR
PENUYU=X	PEN/UYU	CCY	CURRENCY_PAIR
PLNXDR=X	PLN/XDR	CCY	CURRENCY_PAIR
PENDKK=X	PEN/DKK	CCY	CURRENCY_PAIR
PENTHB=X	PEN/THB	CCY	CURRENCY_PAIR
PENCLP=X	PEN/CLP	CCY	CURRENCY_PAIR
PLNCOP=X	PLN/COP	CCY	CURRENCY_PAIR
PLNCZK=X	PLN/CZK	CCY	CURRENCY_PAIR
PHPTND=X	PHP/TND	CCY	CURRENCY_PAIR
PHPUSD=X	PHP/USD	CCY	CURRENCY_PAIR
11729129=X			CURRENCY_PAIR
PLNCHF=X	PLN/CHF	CCY	CURRENCY_PAIR
PKREUR=X	PKR/EUR	CCY	CURRENCY_PAIR
PGKHKD=X	PGK/HKD	CCY	CURRENCY_PAIR
PHPHUF=X	PHP/HUF	CCY	CURRENCY_PAIR
PHPKRW=X	PHP/KRW	CCY	CURRENCY_PAIR
PLNEGP=X	PLN/EGP	CCY	CURRENCY_PAIR
PKRTHB=X	PKR/THB	CCY	CURRENCY_PAIR
PHPMYR=X	PHP/MYR	CCY	CURRENCY_PAIR
PHPTRY=X	PHP/TRY	CCY	CURRENCY_PAIR
PLNZAR=X	PLN/ZAR	CCY	CURRENCY_PAIR
PLNMYR=X	PLN/MYR	CCY	CURRENCY_PAIR
PGK=X	USD/PGK	CCY	CURRENCY_PAIR
PLNINR=X	PLN/INR	CCY	CURRENCY_PAIR
PHPPKR=X	PHP/PKR	CCY	CURRENCY_PAIR
PABCAD=X	PAB/CAD	CCY	CURRENCY_PAIR
PHPTWD=X	PHP/TWD	CCY	CURRENCY_PAIR
PLNVUV=X	PLN/VUV	CCY	CURRENCY_PAIR
PLNHKD=X	PLN/HKD	CCY	CURRENCY_PAIR
PHPLVL=X	PHP/LVL	CCY	CURRENCY_PAIR
PHPEUR=X	PHP/EUR	CCY	CURRENCY_PAIR
PHPCNY=X	PHP/CNY	CCY	CURRENCY_PAIR
PLNUSD=X	PLN/USD	CCY	CURRENCY_PAIR
PLNBMD=X	PLN/BMD	CCY	CURRENCY_PAIR
PGKDKK=X	PGK/DKK	CCY	CURRENCY_PAIR
PENGBP=X	PEN/GBP	CCY	CURRENCY_PAIR
PLNCNY=X	PLN/CNY	CCY	CURRENCY_PAIR
PABUSD=X	PAB/USD	CCY	CURRENCY_PAIR
PLNRON=X	PLN/RON	CCY	CURRENCY_PAIR
PENCHF=X	PEN/CHF	CCY	CURRENCY_PAIR
PENVEF=X	PEN/VEF	CCY	CURRENCY_PAIR
PLNKRW=X	PLN/KRW	CCY	CURRENCY_PAIR
PLNPHP=X	PLN/PHP	CCY	CURRENCY_PAIR
PKRHKD=X	PKR/HKD	CCY	CURRENCY_PAIR
PHPDKK=X	PHP/DKK	CCY	CURRENCY_PAIR
PKRQAR=X	PKR/QAR	CCY	CURRENCY_PAIR
PGKEUR=X	PGK/EUR	CCY	CURRENCY_PAIR
PEN=X	USD/PEN	CCY	CURRENCY_PAIR
PENCOP=X	PEN/COP	CCY	CURRENCY_PAIR
PKRSGD=X	PKR/SGD	CCY	CURRENCY_PAIR
PKRXDR=X	PKR/XDR	CCY	CURRENCY_PAIR
PHPLTL=X	PHP/LTL	CCY	CURRENCY_PAIR
PLNQAR=X	PLN/QAR	CCY	CURRENCY_PAIR
PABEUR=X	PAB/EUR	CCY	CURRENCY_PAIR
PHPMUR=X	PHP/MUR	CCY	CURRENCY_PAIR
PLNMUR=X	PLN/MUR	CCY	CURRENCY_PAIR
PYGCOP=X	PYG/COP	CCY	CURRENCY_PAIR
PLNKWD=X	PLN/KWD	CCY	CURRENCY_PAIR
PHPJPY=X	PHP/JPY	CCY	CURRENCY_PAIR
PLN=X	USD/PLN	CCY	CURRENCY_PAIR
PLNTHB=X	PLN/THB	CCY	CURRENCY_PAIR
PHPMAD=X	PHP/MAD	CCY	CURRENCY_PAIR
PHPVND=X	PHP/VND	CCY	CURRENCY_PAIR
PLNPKR=X	PLN/PKR	CCY	CURRENCY_PAIR
PLNEUR=X	PLN/EUR	CCY	CURRENCY_PAIR
PLNRUB=X	PLN/RUB	CCY	CURRENCY_PAIR
PLNBDT=X	PLN/BDT	CCY	CURRENCY_PAIR
PENEUR=X	PEN/EUR	CCY	CURRENCY_PAIR
PLNAED=X	PLN/AED	CCY	CURRENCY_PAIR
PHPSAR=X	PHP/SAR	CCY	CURRENCY_PAIR
PHPRUB=X	PHP/RUB	CCY	CURRENCY_PAIR
19753805.SW	19753805.SW	EBS	CURRENCY_PAIR
PLNOMR=X	PLN/OMR	CCY	CURRENCY_PAIR
PHPMXN=X	PHP/MXN	CCY	CURRENCY_PAIR
PLNJOD=X	PLN/JOD	CCY	CURRENCY_PAIR
PKRVND=X	PKR/VND	CCY	CURRENCY_PAIR
PHPNOK=X	PHP/NOK	CCY	CURRENCY_PAIR
PABCHF=X	PAB/CHF	CCY	CURRENCY_PAIR
PLNZWL=X	PLN/ZWL	CCY	CURRENCY_PAIR
PLNNZD=X	PLN/NZD	CCY	CURRENCY_PAIR
PKRAUD=X	PKR/AUD	CCY	CURRENCY_PAIR
PHPCAD=X	PHP/CAD	CCY	CURRENCY_PAIR
29134354=X			CURRENCY_PAIR
PLNILS=X	PLN/ILS	CCY	CURRENCY_PAIR
PHPNZD=X	PHP/NZD	CCY	CURRENCY_PAIR
PENMXN=X	PEN/MXN	CCY	CURRENCY_PAIR
PHPEGP=X	PHP/EGP	CCY	CURRENCY_PAIR
PHPJOD=X	PHP/JOD	CCY	CURRENCY_PAIR
PLNNGN=X	PLN/NGN	CCY	CURRENCY_PAIR
PKRUSD=X	PKR/USD	CCY	CURRENCY_PAIR
PLNTND=X	PLN/TND	CCY	CURRENCY_PAIR
PHPQAR=X	PHP/QAR	CCY	CURRENCY_PAIR
PYG=X	USD/PYG	CCY	CURRENCY_PAIR
PLNCAD=X	PLN/CAD	CCY	CURRENCY_PAIR
PGKGBP=X	PGK/GBP	CCY	CURRENCY_PAIR
PLNISK=X	PLN/ISK	CCY	CURRENCY_PAIR
PHPTHB=X	PHP/THB	CCY	CURRENCY_PAIR
PENARS=X	PEN/ARS	CCY	CURRENCY_PAIR
PLNSGD=X	PLN/SGD	CCY	CURRENCY_PAIR
PKRGBP=X	PKR/GBP	CCY	CURRENCY_PAIR
PENUSD=X	PEN/USD	CCY	CURRENCY_PAIR
PHPCZK=X	PHP/CZK	CCY	CURRENCY_PAIR
19753825.SW	19753825.SW	EBS	CURRENCY_PAIR
PLNBOB=X	PLN/BOB	CCY	CURRENCY_PAIR
PLNCLP=X	PLN/CLP	CCY	CURRENCY_PAIR
PLNDKK=X	PLN/DKK	CCY	CURRENCY_PAIR
PHPIDR=X	PHP/IDR	CCY	CURRENCY_PAIR
283501=X			CURRENCY_PAIR
PKRPHP=X	PKR/PHP	CCY	CURRENCY_PAIR
PABGBP=X	PAB/GBP	CCY	CURRENCY_PAIR
PKRKRW=X	PKR/KRW	CCY	CURRENCY_PAIR
PABDKK=X	PAB/DKK	CCY	CURRENCY_PAIR
PYGCLP=X	PYG/CLP	CCY	CURRENCY_PAIR
PHPPLN=X	PHP/PLN	CCY	CURRENCY_PAIR
PLNIDR=X	PLN/IDR	CCY	CURRENCY_PAIR
PLNLTL=X	PLN/LTL	CCY	CURRENCY_PAIR
PENCAD=X	PEN/CAD	CCY	CURRENCY_PAIR
PLNPGK=X	PLN/PGK	CCY	CURRENCY_PAIR
PHPHKD=X	PHP/HKD	CCY	CURRENCY_PAIR
PGKCHF=X	PGK/CHF	CCY	CURRENCY_PAIR
PHPSEK=X	PHP/SEK	CCY	CURRENCY_PAIR
PLNNOK=X	PLN/NOK	CCY	CURRENCY_PAIR
PHPZAR=X	PHP/ZAR	CCY	CURRENCY_PAIR
PKRAED=X	PKR/AED	CCY	CURRENCY_PAIR
PKRINR=X	PKR/INR	CCY	CURRENCY_PAIR
PLNRSD=X	PLN/RSD	CCY	CURRENCY_PAIR
PLNTWD=X	PLN/TWD	CCY	CURRENCY_PAIR
PKRJPY=X	PKR/JPY	CCY	CURRENCY_PAIR
PKRDKK=X	PKR/DKK	CCY	CURRENCY_PAIR
287639=X			CURRENCY_PAIR
PKREGP=X	PKR/EGP	CCY	CURRENCY_PAIR
PHPOMR=X	PHP/OMR	CCY	CURRENCY_PAIR
PENPYG=X	PEN/PYG	CCY	CURRENCY_PAIR
PLNMAD=X	PLN/MAD	CCY	CURRENCY_PAIR
PLNBHD=X	PLN/BHD	CCY	CURRENCY_PAIR
PLNMXN=X	PLN/MXN	CCY	CURRENCY_PAIR
PLNLKR=X	PLN/LKR	CCY	CURRENCY_PAIR
PYGUYU=X	PYG/UYU	CCY	CURRENCY_PAIR
PLNGBP=X	PLN/GBP	CCY	CURRENCY_PAIR
PLNPEN=X	PLN/PEN	CCY	CURRENCY_PAIR
PHPLKR=X	PHP/LKR	CCY	CURRENCY_PAIR
PLNKES=X	PLN/KES	CCY	CURRENCY_PAIR
PLNAUD=X	PLN/AUD	CCY	CURRENCY_PAIR
PKR=X	USD/PKR	CCY	CURRENCY_PAIR
PLNBND=X	PLN/BND	CCY	CURRENCY_PAIR
PHPSGD=X	PHP/SGD	CCY	CURRENCY_PAIR
PLNJPY=X	PLN/JPY	CCY	CURRENCY_PAIR
PLNBRL=X	PLN/BRL	CCY	CURRENCY_PAIR
PHPCHF=X	PHP/CHF	CCY	CURRENCY_PAIR
PHPINR=X	PHP/INR	CCY	CURRENCY_PAIR
PAB=X	USD/PAB	CCY	CURRENCY_PAIR
PHPKES=X	PHP/KES	CCY	CURRENCY_PAIR
PHPGBP=X	PHP/GBP	CCY	CURRENCY_PAIR
PKRCHF=X	PKR/CHF	CCY	CURRENCY_PAIR
PLNARS=X	PLN/ARS	CCY	CURRENCY_PAIR
PHPKWD=X	PHP/KWD	CCY	CURRENCY_PAIR
287642=X			CURRENCY_PAIR
PHPAUD=X	PHP/AUD	CCY	CURRENCY_PAIR
PHPAED=X	PHP/AED	CCY	CURRENCY_PAIR
SEKEUR=X	SEK/EUR	CCY	CURRENCY_PAIR
QARZAR=X	QAR/ZAR	CCY	CURRENCY_PAIR
QARTND=X	QAR/TND	CCY	CURRENCY_PAIR
QARPLN=X	QAR/PLN	CCY	CURRENCY_PAIR
QARKES=X	QAR/KES	CCY	CURRENCY_PAIR
QARINR=X	QAR/INR	CCY	CURRENCY_PAIR
QARIDR=X	QAR/IDR	CCY	CURRENCY_PAIR
QAR=X	USD/QAR	CCY	CURRENCY_PAIR
QARNOK=X	QAR/NOK	CCY	CURRENCY_PAIR
QARSGD=X	QAR/SGD	CCY	CURRENCY_PAIR
QARAED=X	QAR/AED	CCY	CURRENCY_PAIR
QARDKK=X	QAR/DKK	CCY	CURRENCY_PAIR
QARHKD=X	QAR/HKD	CCY	CURRENCY_PAIR
QARLKR=X	QAR/LKR	CCY	CURRENCY_PAIR
QARKWD=X	QAR/KWD	CCY	CURRENCY_PAIR
QAROMR=X	QAR/OMR	CCY	CURRENCY_PAIR
QARISK=X	QAR/ISK	CCY	CURRENCY_PAIR
QARTHB=X	QAR/THB	CCY	CURRENCY_PAIR
QARNZD=X	QAR/NZD	CCY	CURRENCY_PAIR
QARTWD=X	QAR/TWD	CCY	CURRENCY_PAIR
QARRUB=X	QAR/RUB	CCY	CURRENCY_PAIR
QARTRY=X	QAR/TRY	CCY	CURRENCY_PAIR
QARKRW=X	QAR/KRW	CCY	CURRENCY_PAIR
QARILS=X	QAR/ILS	CCY	CURRENCY_PAIR
QARPKR=X	QAR/PKR	CCY	CURRENCY_PAIR
QARSAR=X	QAR/SAR	CCY	CURRENCY_PAIR
QARCAD=X	QAR/CAD	CCY	CURRENCY_PAIR
QARMXN=X	QAR/MXN	CCY	CURRENCY_PAIR
QARCNY=X	QAR/CNY	CCY	CURRENCY_PAIR
QARPHP=X	QAR/PHP	CCY	CURRENCY_PAIR
QARXDR=X	QAR/XDR	CCY	CURRENCY_PAIR
QARAUD=X	QAR/AUD	CCY	CURRENCY_PAIR
QARCHF=X	QAR/CHF	CCY	CURRENCY_PAIR
QARLTL=X	QAR/LTL	CCY	CURRENCY_PAIR
QARUSD=X	QAR/USD	CCY	CURRENCY_PAIR
QARSEK=X	QAR/SEK	CCY	CURRENCY_PAIR
QARCZK=X	QAR/CZK	CCY	CURRENCY_PAIR
QARMAD=X	QAR/MAD	CCY	CURRENCY_PAIR
QAREUR=X	QAR/EUR	CCY	CURRENCY_PAIR
QARJOD=X	QAR/JOD	CCY	CURRENCY_PAIR
QARMUR=X	QAR/MUR	CCY	CURRENCY_PAIR
QARGBP=X	QAR/GBP	CCY	CURRENCY_PAIR
QARBHD=X	QAR/BHD	CCY	CURRENCY_PAIR
QARJPY=X	QAR/JPY	CCY	CURRENCY_PAIR
QARLVL=X	QAR/LVL	CCY	CURRENCY_PAIR
QAREGP=X	QAR/EGP	CCY	CURRENCY_PAIR
QARHUF=X	QAR/HUF	CCY	CURRENCY_PAIR
RUBUSD=X	RUB/USD	CCY	CURRENCY_PAIR
RUBNOK=X	RUB/NOK	CCY	CURRENCY_PAIR
RUBMXN=X	RUB/MXN	CCY	CURRENCY_PAIR
RUBILS=X	RUB/ILS	CCY	CURRENCY_PAIR
RUBGBP=X	RUB/GBP	CCY	CURRENCY_PAIR
RUB=X	USD/RUB	CCY	CURRENCY_PAIR
RONEUR=X	RON/EUR	CCY	CURRENCY_PAIR
RONDKK=X	RON/DKK	CCY	CURRENCY_PAIR
RON=X	USD/RON	CCY	CURRENCY_PAIR
RUBKES=X	RUB/KES	CCY	CURRENCY_PAIR
RONCZK=X	RON/CZK	CCY	CURRENCY_PAIR
RSDCHF=X	RSD/CHF	CCY	CURRENCY_PAIR
RONRSD=X	RON/RSD	CCY	CURRENCY_PAIR
RONSGD=X	RON/SGD	CCY	CURRENCY_PAIR
RUBCZK=X	RUB/CZK	CCY	CURRENCY_PAIR
RONPLN=X	RON/PLN	CCY	CURRENCY_PAIR
RUBAZN=X	RUB/AZN	CCY	CURRENCY_PAIR
RONNZD=X	RON/NZD	CCY	CURRENCY_PAIR
RUBTJS=X	RUB/TJS	CCY	CURRENCY_PAIR
RUBEUR=X	RUB/EUR	CCY	CURRENCY_PAIR
RUBSGD=X	RUB/SGD	CCY	CURRENCY_PAIR
RUBDKK=X	RUB/DKK	CCY	CURRENCY_PAIR
RONCNY=X	RON/CNY	CCY	CURRENCY_PAIR
RSDGBP=X	RSD/GBP	CCY	CURRENCY_PAIR
RUBKZT=X	RUB/KZT	CCY	CURRENCY_PAIR
RSDCAD=X	RSD/CAD	CCY	CURRENCY_PAIR
RUBQAR=X	RUB/QAR	CCY	CURRENCY_PAIR
RUBMAD=X	RUB/MAD	CCY	CURRENCY_PAIR
RUBTWD=X	RUB/TWD	CCY	CURRENCY_PAIR
RUBISK=X	RUB/ISK	CCY	CURRENCY_PAIR
RONAED=X	RON/AED	CCY	CURRENCY_PAIR
RONHRK=X	RON/HRK	CCY	CURRENCY_PAIR
RONILS=X	RON/ILS	CCY	CURRENCY_PAIR
RONLTL=X	RON/LTL	CCY	CURRENCY_PAIR
RONTRY=X	RON/TRY	CCY	CURRENCY_PAIR
RONCAD=X	RON/CAD	CCY	CURRENCY_PAIR
RUBEGP=X	RUB/EGP	CCY	CURRENCY_PAIR
RUBCHF=X	RUB/CHF	CCY	CURRENCY_PAIR
RUBTND=X	RUB/TND	CCY	CURRENCY_PAIR
RONINR=X	RON/INR	CCY	CURRENCY_PAIR
RUBJPY=X	RUB/JPY	CCY	CURRENCY_PAIR
RONKRW=X	RON/KRW	CCY	CURRENCY_PAIR
RUBMDL=X	RUB/MDL	CCY	CURRENCY_PAIR
RUBAED=X	RUB/AED	CCY	CURRENCY_PAIR
RONCHF=X	RON/CHF	CCY	CURRENCY_PAIR
RUBPLN=X	RUB/PLN	CCY	CURRENCY_PAIR
RONUSD=X	RON/USD	CCY	CURRENCY_PAIR
RUBNZD=X	RUB/NZD	CCY	CURRENCY_PAIR
RONRUB=X	RON/RUB	CCY	CURRENCY_PAIR
RONUAH=X	RON/UAH	CCY	CURRENCY_PAIR
RUBINR=X	RUB/INR	CCY	CURRENCY_PAIR
RSDUSD=X	RSD/USD	CCY	CURRENCY_PAIR
RUBKGS=X	RUB/KGS	CCY	CURRENCY_PAIR
RSDDKK=X	RSD/DKK	CCY	CURRENCY_PAIR
RONTHB=X	RON/THB	CCY	CURRENCY_PAIR
RUBUZS=X	RUB/UZS	CCY	CURRENCY_PAIR
RUBTHB=X	RUB/THB	CCY	CURRENCY_PAIR
RSD=X	USD/RSD	CCY	CURRENCY_PAIR
RUBTMT=X	RUB/TMT	CCY	CURRENCY_PAIR
RUBLTL=X	RUB/LTL	CCY	CURRENCY_PAIR
RUBAMD=X	RUB/AMD	CCY	CURRENCY_PAIR
RUBPHP=X	RUB/PHP	CCY	CURRENCY_PAIR
RSDEUR=X	RSD/EUR	CCY	CURRENCY_PAIR
RONAUD=X	RON/AUD	CCY	CURRENCY_PAIR
RUBMYR=X	RUB/MYR	CCY	CURRENCY_PAIR
RUBHKD=X	RUB/HKD	CCY	CURRENCY_PAIR
RUBHUF=X	RUB/HUF	CCY	CURRENCY_PAIR
RONNOK=X	RON/NOK	CCY	CURRENCY_PAIR
RUBBYR=X	RUB/BYR	CCY	CURRENCY_PAIR
RONSEK=X	RON/SEK	CCY	CURRENCY_PAIR
RUBKRW=X	RUB/KRW	CCY	CURRENCY_PAIR
RONHKD=X	RON/HKD	CCY	CURRENCY_PAIR
RUBSEK=X	RUB/SEK	CCY	CURRENCY_PAIR
RONZAR=X	RON/ZAR	CCY	CURRENCY_PAIR
RONKWD=X	RON/KWD	CCY	CURRENCY_PAIR
RONJPY=X	RON/JPY	CCY	CURRENCY_PAIR
RONBRL=X	RON/BRL	CCY	CURRENCY_PAIR
RUBMUR=X	RUB/MUR	CCY	CURRENCY_PAIR
RUBIDR=X	RUB/IDR	CCY	CURRENCY_PAIR
RUBCAD=X	RUB/CAD	CCY	CURRENCY_PAIR
RUBZAR=X	RUB/ZAR	CCY	CURRENCY_PAIR
RUBJOD=X	RUB/JOD	CCY	CURRENCY_PAIR
RUBTRY=X	RUB/TRY	CCY	CURRENCY_PAIR
RUBSAR=X	RUB/SAR	CCY	CURRENCY_PAIR
RWF=X	USD/RWF	CCY	CURRENCY_PAIR
RUBAUD=X	RUB/AUD	CCY	CURRENCY_PAIR
RUBBRL=X	RUB/BRL	CCY	CURRENCY_PAIR
RONGBP=X	RON/GBP	CCY	CURRENCY_PAIR
RUBLKR=X	RUB/LKR	CCY	CURRENCY_PAIR
RUBOMR=X	RUB/OMR	CCY	CURRENCY_PAIR
RUBCNY=X	RUB/CNY	CCY	CURRENCY_PAIR
SZLGBP=X	SZL/GBP	CCY	CURRENCY_PAIR
SZLCHF=X	SZL/CHF	CCY	CURRENCY_PAIR
SYP=X	USD/SYP	CCY	CURRENCY_PAIR
SLL=X	USD/SLL	CCY	CURRENCY_PAIR
SGDMYR=X	SGD/MYR	CCY	CURRENCY_PAIR
SGDMAD=X	SGD/MAD	CCY	CURRENCY_PAIR
SGDINR=X	SGD/INR	CCY	CURRENCY_PAIR
SGDHKD=X	SGD/HKD	CCY	CURRENCY_PAIR
SGDGHS=X	SGD/GHS	CCY	CURRENCY_PAIR
SGDCZK=X	SGD/CZK	CCY	CURRENCY_PAIR
SGDCLP=X	SGD/CLP	CCY	CURRENCY_PAIR
SEKUSD=X	SEK/USD	CCY	CURRENCY_PAIR
SEKMAD=X	SEK/MAD	CCY	CURRENCY_PAIR
SEKLTL=X	SEK/LTL	CCY	CURRENCY_PAIR
SEKHUF=X	SEK/HUF	CCY	CURRENCY_PAIR
SEKGBP=X	SEK/GBP	CCY	CURRENCY_PAIR
SEKDKK=X	SEK/DKK	CCY	CURRENCY_PAIR
SEKBGN=X	SEK/BGN	CCY	CURRENCY_PAIR
SARZAR=X	SAR/ZAR	CCY	CURRENCY_PAIR
SARCZK=X	SAR/CZK	CCY	CURRENCY_PAIR
SGDOMR=X	SGD/OMR	CCY	CURRENCY_PAIR
SARPLN=X	SAR/PLN	CCY	CURRENCY_PAIR
SGDBHD=X	SGD/BHD	CCY	CURRENCY_PAIR
SGDCNY=X	SGD/CNY	CCY	CURRENCY_PAIR
19753421.SW			CURRENCY_PAIR
19754120.SW	19754120.SW	EBS	CURRENCY_PAIR
SARMUR=X	SAR/MUR	CCY	CURRENCY_PAIR
SARPHP=X	SAR/PHP	CCY	CURRENCY_PAIR
SEKKWD=X	SEK/KWD	CCY	CURRENCY_PAIR
SYPHKD=X	SYP/HKD	CCY	CURRENCY_PAIR
SARNZD=X	SAR/NZD	CCY	CURRENCY_PAIR
19754264.SW	19754264.SW	EBS	CURRENCY_PAIR
SARPKR=X	SAR/PKR	CCY	CURRENCY_PAIR
SGDMXN=X	SGD/MXN	CCY	CURRENCY_PAIR
SGDKRW=X	SGD/KRW	CCY	CURRENCY_PAIR
SARCHF=X	SAR/CHF	CCY	CURRENCY_PAIR
SCRDKK=X	SCR/DKK	CCY	CURRENCY_PAIR
SARCAD=X	SAR/CAD	CCY	CURRENCY_PAIR
SCRGBP=X	SCR/GBP	CCY	CURRENCY_PAIR
29134357=X			CURRENCY_PAIR
SARNOK=X	SAR/NOK	CCY	CURRENCY_PAIR
19753561.SW			CURRENCY_PAIR
SGDZAR=X	SGD/ZAR	CCY	CURRENCY_PAIR
SBDEUR=X	SBD/EUR	CCY	CURRENCY_PAIR
SGDBMD=X	SGD/BMD	CCY	CURRENCY_PAIR
SGDRUB=X	SGD/RUB	CCY	CURRENCY_PAIR
SGDBDT=X	SGD/BDT	CCY	CURRENCY_PAIR
SGDVND=X	SGD/VND	CCY	CURRENCY_PAIR
SARTHB=X	SAR/THB	CCY	CURRENCY_PAIR
SGDPLN=X	SGD/PLN	CCY	CURRENCY_PAIR
SDGEUR=X	SDG/EUR	CCY	CURRENCY_PAIR
SARAED=X	SAR/AED	CCY	CURRENCY_PAIR
SEKXDR=X	SEK/XDR	CCY	CURRENCY_PAIR
19753442.SW	19753442.SW	EBS	CURRENCY_PAIR
SARIDR=X	SAR/IDR	CCY	CURRENCY_PAIR
SEKSAR=X	SEK/SAR	CCY	CURRENCY_PAIR
SVCGBP=X	SVC/GBP	CCY	CURRENCY_PAIR
SEKTHB=X	SEK/THB	CCY	CURRENCY_PAIR
SARLVL=X	SAR/LVL	CCY	CURRENCY_PAIR
SEKKPW=X	SEK/KPW	CCY	CURRENCY_PAIR
SARINR=X	SAR/INR	CCY	CURRENCY_PAIR
SGDAED=X	SGD/AED	CCY	CURRENCY_PAIR
SGDBRL=X	SGD/BRL	CCY	CURRENCY_PAIR
SEKBWP=X	SEK/BWP	CCY	CURRENCY_PAIR
SGDXDR=X	SGD/XDR	CCY	CURRENCY_PAIR
SEKRON=X	SEK/RON	CCY	CURRENCY_PAIR
SEKTRY=X	SEK/TRY	CCY	CURRENCY_PAIR
SRDCHF=X	SRD/CHF	CCY	CURRENCY_PAIR
SAR=X	USD/SAR	CCY	CURRENCY_PAIR
SGDJOD=X	SGD/JOD	CCY	CURRENCY_PAIR
SCRUSD=X	SCR/USD	CCY	CURRENCY_PAIR
SGDISK=X	SGD/ISK	CCY	CURRENCY_PAIR
SEKKES=X	SEK/KES	CCY	CURRENCY_PAIR
SAREGP=X	SAR/EGP	CCY	CURRENCY_PAIR
19753424.SW			CURRENCY_PAIR
SZLUSD=X	SZL/USD	CCY	CURRENCY_PAIR
SGDAUD=X	SGD/AUD	CCY	CURRENCY_PAIR
SGDNGN=X	SGD/NGN	CCY	CURRENCY_PAIR
SBDGBP=X	SBD/GBP	CCY	CURRENCY_PAIR
SHP=X	USD/SHP	CCY	CURRENCY_PAIR
SEK=X	USD/SEK	CCY	CURRENCY_PAIR
SEKCAD=X	SEK/CAD	CCY	CURRENCY_PAIR
19838326.SW	19838326.SW	EBS	CURRENCY_PAIR
SBDCHF=X	SBD/CHF	CCY	CURRENCY_PAIR
SZLEUR=X	SZL/EUR	CCY	CURRENCY_PAIR
SARQAR=X	SAR/QAR	CCY	CURRENCY_PAIR
SYPCHF=X	SYP/CHF	CCY	CURRENCY_PAIR
SEKMUR=X	SEK/MUR	CCY	CURRENCY_PAIR
STD=X	USD/STD	CCY	CURRENCY_PAIR
SARMAD=X	SAR/MAD	CCY	CURRENCY_PAIR
SEKRUB=X	SEK/RUB	CCY	CURRENCY_PAIR
SGDMOP=X	SGD/MOP	CCY	CURRENCY_PAIR
19753443.SW			CURRENCY_PAIR
SGDUGX=X	SGD/UGX	CCY	CURRENCY_PAIR
SGDPEN=X	SGD/PEN	CCY	CURRENCY_PAIR
SARUSD=X	SAR/USD	CCY	CURRENCY_PAIR
SGDHUF=X	SGD/HUF	CCY	CURRENCY_PAIR
SGDCHF=X	SGD/CHF	CCY	CURRENCY_PAIR
SEKTWD=X	SEK/TWD	CCY	CURRENCY_PAIR
SARTWD=X	SAR/TWD	CCY	CURRENCY_PAIR
SEKCHF=X	SEK/CHF	CCY	CURRENCY_PAIR
SEKCNY=X	SEK/CNY	CCY	CURRENCY_PAIR
SCR=X	USD/SCR	CCY	CURRENCY_PAIR
19838330.SW			CURRENCY_PAIR
SGDZWL=X	SGD/ZWL	CCY	CURRENCY_PAIR
SARILS=X	SAR/ILS	CCY	CURRENCY_PAIR
SEKCNH=X	SEK/CNH	CCY	CURRENCY_PAIR
10366999.EX	10366999.EX	EUX	CURRENCY_PAIR
SGDCAD=X	SGD/CAD	CCY	CURRENCY_PAIR
SARKRW=X	SAR/KRW	CCY	CURRENCY_PAIR
SEKJPY=X	SEK/JPY	CCY	CURRENCY_PAIR
SGDPHP=X	SGD/PHP	CCY	CURRENCY_PAIR
SEKTND=X	SEK/TND	CCY	CURRENCY_PAIR
19753566.SW	19753566.SW	EBS	CURRENCY_PAIR
SGDQAR=X	SGD/QAR	CCY	CURRENCY_PAIR
SEKRSD=X	SEK/RSD	CCY	CURRENCY_PAIR
SEKCLP=X	SEK/CLP	CCY	CURRENCY_PAIR
SEKSGD=X	SEK/SGD	CCY	CURRENCY_PAIR
SGDBGN=X	SGD/BGN	CCY	CURRENCY_PAIR
SEKKRW=X	SEK/KRW	CCY	CURRENCY_PAIR
SARGBP=X	SAR/GBP	CCY	CURRENCY_PAIR
SGDBWP=X	SGD/BWP	CCY	CURRENCY_PAIR
SVCUSD=X	SVC/USD	CCY	CURRENCY_PAIR
SGDLBP=X	SGD/LBP	CCY	CURRENCY_PAIR
SEKISK=X	SEK/ISK	CCY	CURRENCY_PAIR
29134356=X			CURRENCY_PAIR
SEKJMD=X	SEK/JMD	CCY	CURRENCY_PAIR
SARISK=X	SAR/ISK	CCY	CURRENCY_PAIR
SGDEGP=X	SGD/EGP	CCY	CURRENCY_PAIR
SIT=X	USD/SIT	CCY	CURRENCY_PAIR
SDGGBP=X	SDG/GBP	CCY	CURRENCY_PAIR
SOS=X	USD/SOS	CCY	CURRENCY_PAIR
SGDMUR=X	SGD/MUR	CCY	CURRENCY_PAIR
19753568.SW	19753568.SW	EBS	CURRENCY_PAIR
SARLKR=X	SAR/LKR	CCY	CURRENCY_PAIR
SGDPKR=X	SGD/PKR	CCY	CURRENCY_PAIR
SARHUF=X	SAR/HUF	CCY	CURRENCY_PAIR
SARBHD=X	SAR/BHD	CCY	CURRENCY_PAIR
29134355=X			CURRENCY_PAIR
SEKQAR=X	SEK/QAR	CCY	CURRENCY_PAIR
SARJPY=X	SAR/JPY	CCY	CURRENCY_PAIR
SARCNY=X	SAR/CNY	CCY	CURRENCY_PAIR
SEKILS=X	SEK/ILS	CCY	CURRENCY_PAIR
SARXDR=X	SAR/XDR	CCY	CURRENCY_PAIR
SARKWD=X	SAR/KWD	CCY	CURRENCY_PAIR
SARDKK=X	SAR/DKK	CCY	CURRENCY_PAIR
SRDUSD=X	SRD/USD	CCY	CURRENCY_PAIR
SRDEUR=X	SRD/EUR	CCY	CURRENCY_PAIR
SARSEK=X	SAR/SEK	CCY	CURRENCY_PAIR
SBDUSD=X	SBD/USD	CCY	CURRENCY_PAIR
SGDKWD=X	SGD/KWD	CCY	CURRENCY_PAIR
SEKAED=X	SEK/AED	CCY	CURRENCY_PAIR
SEKINR=X	SEK/INR	CCY	CURRENCY_PAIR
SGDTWD=X	SGD/TWD	CCY	CURRENCY_PAIR
19753440.SW			CURRENCY_PAIR
SARSGD=X	SAR/SGD	CCY	CURRENCY_PAIR
SGDARS=X	SGD/ARS	CCY	CURRENCY_PAIR
SHPCHF=X	SHP/CHF	CCY	CURRENCY_PAIR
SEKGIP=X	SEK/GIP	CCY	CURRENCY_PAIR
SARTRY=X	SAR/TRY	CCY	CURRENCY_PAIR
SYPSGD=X	SYP/SGD	CCY	CURRENCY_PAIR
SEKANG=X	SEK/ANG	CCY	CURRENCY_PAIR
SARLTL=X	SAR/LTL	CCY	CURRENCY_PAIR
SEKBAM=X	SEK/BAM	CCY	CURRENCY_PAIR
SYPQAR=X	SYP/QAR	CCY	CURRENCY_PAIR
SYPDKK=X	SYP/DKK	CCY	CURRENCY_PAIR
SGDCNH=X	SGD/CNH	CCY	CURRENCY_PAIR
SEKMYR=X	SEK/MYR	CCY	CURRENCY_PAIR
SGD=X	USD/SGD	CCY	CURRENCY_PAIR
SEKMXN=X	SEK/MXN	CCY	CURRENCY_PAIR
SGDUYU=X	SGD/UYU	CCY	CURRENCY_PAIR
SARHKD=X	SAR/HKD	CCY	CURRENCY_PAIR
SARAUD=X	SAR/AUD	CCY	CURRENCY_PAIR
SGDILS=X	SGD/ILS	CCY	CURRENCY_PAIR
SEKEGP=X	SEK/EGP	CCY	CURRENCY_PAIR
SZL=X	USD/SZL	CCY	CURRENCY_PAIR
SEKPKR=X	SEK/PKR	CCY	CURRENCY_PAIR
SGDLTL=X	SGD/LTL	CCY	CURRENCY_PAIR
SHPUSD=X	SHP/USD	CCY	CURRENCY_PAIR
19754261.SW	19754261.SW	EBS	CURRENCY_PAIR
SCRCHF=X	SCR/CHF	CCY	CURRENCY_PAIR
SARTND=X	SAR/TND	CCY	CURRENCY_PAIR
SEKAMD=X	SEK/AMD	CCY	CURRENCY_PAIR
SEKPLN=X	SEK/PLN	CCY	CURRENCY_PAIR
SGDBOB=X	SGD/BOB	CCY	CURRENCY_PAIR
SDGUSD=X	SDG/USD	CCY	CURRENCY_PAIR
SRDGBP=X	SRD/GBP	CCY	CURRENCY_PAIR
SEKLKR=X	SEK/LKR	CCY	CURRENCY_PAIR
SGDTHB=X	SGD/THB	CCY	CURRENCY_PAIR
SAROMR=X	SAR/OMR	CCY	CURRENCY_PAIR
SEKBRL=X	SEK/BRL	CCY	CURRENCY_PAIR
SARJOD=X	SAR/JOD	CCY	CURRENCY_PAIR
SGDVEF=X	SGD/VEF	CCY	CURRENCY_PAIR
SBD=X	USD/SBD	CCY	CURRENCY_PAIR
19753564.SW			CURRENCY_PAIR
SEKHKD=X	SEK/HKD	CCY	CURRENCY_PAIR
SVC=X	USD/SVC	CCY	CURRENCY_PAIR
SGDJPY=X	SGD/JPY	CCY	CURRENCY_PAIR
SEKIDR=X	SEK/IDR	CCY	CURRENCY_PAIR
SVCEUR=X	SVC/EUR	CCY	CURRENCY_PAIR
SGDTRY=X	SGD/TRY	CCY	CURRENCY_PAIR
SGDLKR=X	SGD/LKR	CCY	CURRENCY_PAIR
10367025.EX			CURRENCY_PAIR
SEKCZK=X	SEK/CZK	CCY	CURRENCY_PAIR
SARRUB=X	SAR/RUB	CCY	CURRENCY_PAIR
SGDEUR=X	SGD/EUR	CCY	CURRENCY_PAIR
SGDUSD=X	SGD/USD	CCY	CURRENCY_PAIR
SGDSAR=X	SGD/SAR	CCY	CURRENCY_PAIR
SGDCOP=X	SGD/COP	CCY	CURRENCY_PAIR
SARKES=X	SAR/KES	CCY	CURRENCY_PAIR
SEKPHP=X	SEK/PHP	CCY	CURRENCY_PAIR
SCREUR=X	SCR/EUR	CCY	CURRENCY_PAIR
SYPUSD=X	SYP/USD	CCY	CURRENCY_PAIR
SRD=X	USD/SRD	CCY	CURRENCY_PAIR
SVCCHF=X	SVC/CHF	CCY	CURRENCY_PAIR
SEKOMR=X	SEK/OMR	CCY	CURRENCY_PAIR
SEKJOD=X	SEK/JOD	CCY	CURRENCY_PAIR
SGDNZD=X	SGD/NZD	CCY	CURRENCY_PAIR
10366938.EX	10366938.EX	EUX	CURRENCY_PAIR
SARMXN=X	SAR/MXN	CCY	CURRENCY_PAIR
SGDKES=X	SGD/KES	CCY	CURRENCY_PAIR
SGDTND=X	SGD/TND	CCY	CURRENCY_PAIR
SGDIDR=X	SGD/IDR	CCY	CURRENCY_PAIR
SAREUR=X	SAR/EUR	CCY	CURRENCY_PAIR
SDG=X	USD/SDG	CCY	CURRENCY_PAIR
SGDDKK=X	SGD/DKK	CCY	CURRENCY_PAIR
SDGCHF=X	SDG/CHF	CCY	CURRENCY_PAIR
TWDUSD=X	TWD/USD	CCY	CURRENCY_PAIR
TWDSGD=X	TWD/SGD	CCY	CURRENCY_PAIR
TWDMAD=X	TWD/MAD	CCY	CURRENCY_PAIR
TWDKRW=X	TWD/KRW	CCY	CURRENCY_PAIR
TWDJOD=X	TWD/JOD	CCY	CURRENCY_PAIR
TWDILS=X	TWD/ILS	CCY	CURRENCY_PAIR
TWDCNH=X	TWD/CNH	CCY	CURRENCY_PAIR
TRYUSD=X	TRY/USD	CCY	CURRENCY_PAIR
TRYMAD=X	TRY/MAD	CCY	CURRENCY_PAIR
TRYLKR=X	TRY/LKR	CCY	CURRENCY_PAIR
TRYKWD=X	TRY/KWD	CCY	CURRENCY_PAIR
TRYKES=X	TRY/KES	CCY	CURRENCY_PAIR
TRYJPY=X	TRY/JPY	CCY	CURRENCY_PAIR
TRYGBP=X	TRY/GBP	CCY	CURRENCY_PAIR
TRYEUR=X	TRY/EUR	CCY	CURRENCY_PAIR
TRYBRL=X	TRY/BRL	CCY	CURRENCY_PAIR
TOPEUR=X	TOP/EUR	CCY	CURRENCY_PAIR
TNDSEK=X	TND/SEK	CCY	CURRENCY_PAIR
TNDRUB=X	TND/RUB	CCY	CURRENCY_PAIR
TNDLVL=X	TND/LVL	CCY	CURRENCY_PAIR
TNDISK=X	TND/ISK	CCY	CURRENCY_PAIR
TNDDKK=X	TND/DKK	CCY	CURRENCY_PAIR
TNDCZK=X	TND/CZK	CCY	CURRENCY_PAIR
THBTWD=X	THB/TWD	CCY	CURRENCY_PAIR
THBTRY=X	THB/TRY	CCY	CURRENCY_PAIR
THBSGD=X	THB/SGD	CCY	CURRENCY_PAIR
THBNGN=X	THB/NGN	CCY	CURRENCY_PAIR
THBEUR=X	THB/EUR	CCY	CURRENCY_PAIR
THBDKK=X	THB/DKK	CCY	CURRENCY_PAIR
THBCHF=X	THB/CHF	CCY	CURRENCY_PAIR
TJSUSD=X	TJS/USD	CCY	CURRENCY_PAIR
TNDPHP=X	TND/PHP	CCY	CURRENCY_PAIR
THBAUD=X	THB/AUD	CCY	CURRENCY_PAIR
TNDAUD=X	TND/AUD	CCY	CURRENCY_PAIR
TWDSAR=X	TWD/SAR	CCY	CURRENCY_PAIR
TNDLKR=X	TND/LKR	CCY	CURRENCY_PAIR
TTDCAD=X	TTD/CAD	CCY	CURRENCY_PAIR
TNDEGP=X	TND/EGP	CCY	CURRENCY_PAIR
THBISK=X	THB/ISK	CCY	CURRENCY_PAIR
TWD=X	USD/TWD	CCY	CURRENCY_PAIR
TWDCNY=X	TWD/CNY	CCY	CURRENCY_PAIR
TRYDKK=X	TRY/DKK	CCY	CURRENCY_PAIR
TNDCAD=X	TND/CAD	CCY	CURRENCY_PAIR
THBLTL=X	THB/LTL	CCY	CURRENCY_PAIR
TNDSAR=X	TND/SAR	CCY	CURRENCY_PAIR
THBIDR=X	THB/IDR	CCY	CURRENCY_PAIR
TRYILS=X	TRY/ILS	CCY	CURRENCY_PAIR
TRYAED=X	TRY/AED	CCY	CURRENCY_PAIR
TNDILS=X	TND/ILS	CCY	CURRENCY_PAIR
TWDKES=X	TWD/KES	CCY	CURRENCY_PAIR
THBEGP=X	THB/EGP	CCY	CURRENCY_PAIR
TWDMXN=X	TWD/MXN	CCY	CURRENCY_PAIR
TWDLTL=X	TWD/LTL	CCY	CURRENCY_PAIR
THBKRW=X	THB/KRW	CCY	CURRENCY_PAIR
TRYZAR=X	TRY/ZAR	CCY	CURRENCY_PAIR
TWDLKR=X	TWD/LKR	CCY	CURRENCY_PAIR
THBLBP=X	THB/LBP	CCY	CURRENCY_PAIR
THBPHP=X	THB/PHP	CCY	CURRENCY_PAIR
TRYINR=X	TRY/INR	CCY	CURRENCY_PAIR
TWDGBP=X	TWD/GBP	CCY	CURRENCY_PAIR
THBNZD=X	THB/NZD	CCY	CURRENCY_PAIR
TZS=X	USD/TZS	CCY	CURRENCY_PAIR
THBOMR=X	THB/OMR	CCY	CURRENCY_PAIR
TTDCHF=X	TTD/CHF	CCY	CURRENCY_PAIR
TNDTWD=X	TND/TWD	CCY	CURRENCY_PAIR
TNDTHB=X	TND/THB	CCY	CURRENCY_PAIR
TNDJOD=X	TND/JOD	CCY	CURRENCY_PAIR
29134359=X			CURRENCY_PAIR
THBCAD=X	THB/CAD	CCY	CURRENCY_PAIR
TTDGBP=X	TTD/GBP	CCY	CURRENCY_PAIR
TRYCHF=X	TRY/CHF	CCY	CURRENCY_PAIR
TWDHKD=X	TWD/HKD	CCY	CURRENCY_PAIR
TRYTWD=X	TRY/TWD	CCY	CURRENCY_PAIR
TMT=X	USD/TMT	CCY	CURRENCY_PAIR
TWDNZD=X	TWD/NZD	CCY	CURRENCY_PAIR
THBAED=X	THB/AED	CCY	CURRENCY_PAIR
TMTCHF=X	TMT/CHF	CCY	CURRENCY_PAIR
THBRUB=X	THB/RUB	CCY	CURRENCY_PAIR
THBVEF=X	THB/VEF	CCY	CURRENCY_PAIR
TNDLTL=X	TND/LTL	CCY	CURRENCY_PAIR
TWDHUF=X	TWD/HUF	CCY	CURRENCY_PAIR
TRYCNY=X	TRY/CNY	CCY	CURRENCY_PAIR
TWDAUD=X	TWD/AUD	CCY	CURRENCY_PAIR
TNDIDR=X	TND/IDR	CCY	CURRENCY_PAIR
TWDMYR=X	TWD/MYR	CCY	CURRENCY_PAIR
THBZWL=X	THB/ZWL	CCY	CURRENCY_PAIR
TNDNZD=X	TND/NZD	CCY	CURRENCY_PAIR
TTD=X	USD/TTD	CCY	CURRENCY_PAIR
THBBRL=X	THB/BRL	CCY	CURRENCY_PAIR
THBKWD=X	THB/KWD	CCY	CURRENCY_PAIR
TWDAED=X	TWD/AED	CCY	CURRENCY_PAIR
TRYOMR=X	TRY/OMR	CCY	CURRENCY_PAIR
TNDZAR=X	TND/ZAR	CCY	CURRENCY_PAIR
THBPLN=X	THB/PLN	CCY	CURRENCY_PAIR
THBCOP=X	THB/COP	CCY	CURRENCY_PAIR
TWDISK=X	TWD/ISK	CCY	CURRENCY_PAIR
TRYCAD=X	TRY/CAD	CCY	CURRENCY_PAIR
TRYNOK=X	TRY/NOK	CCY	CURRENCY_PAIR
THBBMD=X	THB/BMD	CCY	CURRENCY_PAIR
TWDIDR=X	TWD/IDR	CCY	CURRENCY_PAIR
TWDKWD=X	TWD/KWD	CCY	CURRENCY_PAIR
THBQAR=X	THB/QAR	CCY	CURRENCY_PAIR
TRYLVL=X	TRY/LVL	CCY	CURRENCY_PAIR
TMTUSD=X	TMT/USD	CCY	CURRENCY_PAIR
TNDHUF=X	TND/HUF	CCY	CURRENCY_PAIR
THBBOB=X	THB/BOB	CCY	CURRENCY_PAIR
THBMXN=X	THB/MXN	CCY	CURRENCY_PAIR
TNDAED=X	TND/AED	CCY	CURRENCY_PAIR
TRYTHB=X	TRY/THB	CCY	CURRENCY_PAIR
TRYAUD=X	TRY/AUD	CCY	CURRENCY_PAIR
TTDXDR=X	TTD/XDR	CCY	CURRENCY_PAIR
TWDQAR=X	TWD/QAR	CCY	CURRENCY_PAIR
TRYEGP=X	TRY/EGP	CCY	CURRENCY_PAIR
THBPKR=X	THB/PKR	CCY	CURRENCY_PAIR
THBSEK=X	THB/SEK	CCY	CURRENCY_PAIR
TNDKWD=X	TND/KWD	CCY	CURRENCY_PAIR
THBNOK=X	THB/NOK	CCY	CURRENCY_PAIR
TRYISK=X	TRY/ISK	CCY	CURRENCY_PAIR
TRYJOD=X	TRY/JOD	CCY	CURRENCY_PAIR
TRYHKD=X	TRY/HKD	CCY	CURRENCY_PAIR
THBKES=X	THB/KES	CCY	CURRENCY_PAIR
THBJOD=X	THB/JOD	CCY	CURRENCY_PAIR
THBLKR=X	THB/LKR	CCY	CURRENCY_PAIR
TNDKES=X	TND/KES	CCY	CURRENCY_PAIR
TNDSGD=X	TND/SGD	CCY	CURRENCY_PAIR
TTDUSD=X	TTD/USD	CCY	CURRENCY_PAIR
TWDZAR=X	TWD/ZAR	CCY	CURRENCY_PAIR
29134360=X			CURRENCY_PAIR
TRYMYR=X	TRY/MYR	CCY	CURRENCY_PAIR
TRYCLP=X	TRY/CLP	CCY	CURRENCY_PAIR
TNDINR=X	TND/INR	CCY	CURRENCY_PAIR
TTDEUR=X	TTD/EUR	CCY	CURRENCY_PAIR
TRYCZK=X	TRY/CZK	CCY	CURRENCY_PAIR
TRYIDR=X	TRY/IDR	CCY	CURRENCY_PAIR
TWDPHP=X	TWD/PHP	CCY	CURRENCY_PAIR
TRY=X	USD/TRY	CCY	CURRENCY_PAIR
THBBHD=X	THB/BHD	CCY	CURRENCY_PAIR
THBCZK=X	THB/CZK	CCY	CURRENCY_PAIR
THBHUF=X	THB/HUF	CCY	CURRENCY_PAIR
THBUYU=X	THB/UYU	CCY	CURRENCY_PAIR
TOPGBP=X	TOP/GBP	CCY	CURRENCY_PAIR
TNDMUR=X	TND/MUR	CCY	CURRENCY_PAIR
TNDGBP=X	TND/GBP	CCY	CURRENCY_PAIR
TRYTND=X	TRY/TND	CCY	CURRENCY_PAIR
TWDPKR=X	TWD/PKR	CCY	CURRENCY_PAIR
TRYNZD=X	TRY/NZD	CCY	CURRENCY_PAIR
TRYRUB=X	TRY/RUB	CCY	CURRENCY_PAIR
THBLVL=X	THB/LVL	CCY	CURRENCY_PAIR
TRYPHP=X	TRY/PHP	CCY	CURRENCY_PAIR
TNDNOK=X	TND/NOK	CCY	CURRENCY_PAIR
TNDKRW=X	TND/KRW	CCY	CURRENCY_PAIR
TND=X	USD/TND	CCY	CURRENCY_PAIR
29134358=X			CURRENCY_PAIR
TNDCHF=X	TND/CHF	CCY	CURRENCY_PAIR
TJS=X	USD/TJS	CCY	CURRENCY_PAIR
TWDCAD=X	TWD/CAD	CCY	CURRENCY_PAIR
TWDEGP=X	TWD/EGP	CCY	CURRENCY_PAIR
TNDHKD=X	TND/HKD	CCY	CURRENCY_PAIR
THBMAD=X	THB/MAD	CCY	CURRENCY_PAIR
TWDTND=X	TWD/TND	CCY	CURRENCY_PAIR
TNDEUR=X	TND/EUR	CCY	CURRENCY_PAIR
TWDDKK=X	TWD/DKK	CCY	CURRENCY_PAIR
TWDOMR=X	TWD/OMR	CCY	CURRENCY_PAIR
TOPCHF=X	TOP/CHF	CCY	CURRENCY_PAIR
THBARS=X	THB/ARS	CCY	CURRENCY_PAIR
TRYSEK=X	TRY/SEK	CCY	CURRENCY_PAIR
TWDCHF=X	TWD/CHF	CCY	CURRENCY_PAIR
TNDCNY=X	TND/CNY	CCY	CURRENCY_PAIR
TNDPLN=X	TND/PLN	CCY	CURRENCY_PAIR
THBCNY=X	THB/CNY	CCY	CURRENCY_PAIR
TWDRUB=X	TWD/RUB	CCY	CURRENCY_PAIR
TNDUSD=X	TND/USD	CCY	CURRENCY_PAIR
THBSAR=X	THB/SAR	CCY	CURRENCY_PAIR
THBCLP=X	THB/CLP	CCY	CURRENCY_PAIR
TRYHUF=X	TRY/HUF	CCY	CURRENCY_PAIR
TWDTHB=X	TWD/THB	CCY	CURRENCY_PAIR
THBMUR=X	THB/MUR	CCY	CURRENCY_PAIR
TWDSEK=X	TWD/SEK	CCY	CURRENCY_PAIR
THBXDR=X	THB/XDR	CCY	CURRENCY_PAIR
TRYQAR=X	TRY/QAR	CCY	CURRENCY_PAIR
TWDCZK=X	TWD/CZK	CCY	CURRENCY_PAIR
THBPEN=X	THB/PEN	CCY	CURRENCY_PAIR
TRYMUR=X	TRY/MUR	CCY	CURRENCY_PAIR
TRYSGD=X	TRY/SGD	CCY	CURRENCY_PAIR
THBMYR=X	THB/MYR	CCY	CURRENCY_PAIR
THBINR=X	THB/INR	CCY	CURRENCY_PAIR
TOPUSD=X	TOP/USD	CCY	CURRENCY_PAIR
TWDJPY=X	TWD/JPY	CCY	CURRENCY_PAIR
TWDMUR=X	TWD/MUR	CCY	CURRENCY_PAIR
TRYPLN=X	TRY/PLN	CCY	CURRENCY_PAIR
THBILS=X	THB/ILS	CCY	CURRENCY_PAIR
TNDJPY=X	TND/JPY	CCY	CURRENCY_PAIR
TWDTRY=X	TWD/TRY	CCY	CURRENCY_PAIR
TNDTRY=X	TND/TRY	CCY	CURRENCY_PAIR
TRYMXN=X	TRY/MXN	CCY	CURRENCY_PAIR
TWDINR=X	TWD/INR	CCY	CURRENCY_PAIR
THBUSD=X	THB/USD	CCY	CURRENCY_PAIR
TNDQAR=X	TND/QAR	CCY	CURRENCY_PAIR
THBZAR=X	THB/ZAR	CCY	CURRENCY_PAIR
TNDOMR=X	TND/OMR	CCY	CURRENCY_PAIR
TRYSAR=X	TRY/SAR	CCY	CURRENCY_PAIR
TWDEUR=X	TWD/EUR	CCY	CURRENCY_PAIR
TWDPLN=X	TWD/PLN	CCY	CURRENCY_PAIR
THBTND=X	THB/TND	CCY	CURRENCY_PAIR
TOP=X	USD/TOP	CCY	CURRENCY_PAIR
TRYLTL=X	TRY/LTL	CCY	CURRENCY_PAIR
TJSCHF=X	TJS/CHF	CCY	CURRENCY_PAIR
THBJPY=X	THB/JPY	CCY	CURRENCY_PAIR
TTDDKK=X	TTD/DKK	CCY	CURRENCY_PAIR
TWDLVL=X	TWD/LVL	CCY	CURRENCY_PAIR
THBHKD=X	THB/HKD	CCY	CURRENCY_PAIR
TWDNOK=X	TWD/NOK	CCY	CURRENCY_PAIR
TZSINR=X	TZS/INR	CCY	CURRENCY_PAIR
TRYKRW=X	TRY/KRW	CCY	CURRENCY_PAIR
THB=X	USD/THB	CCY	CURRENCY_PAIR
TNDMXN=X	TND/MXN	CCY	CURRENCY_PAIR
THBGBP=X	THB/GBP	CCY	CURRENCY_PAIR
TNDMAD=X	TND/MAD	CCY	CURRENCY_PAIR
ZWL=X	USD/ZWL	CCY	CURRENCY_PAIR
XOF=X	USD/XOF	CCY	CURRENCY_PAIR
XCD=X	USD/XCD	CCY	CURRENCY_PAIR
VND=X	USD/VND	CCY	CURRENCY_PAIR
UZS=X	USD/UZS	CCY	CURRENCY_PAIR
UYUBRL=X	UYU/BRL	CCY	CURRENCY_PAIR
UYUBOB=X	UYU/BOB	CCY	CURRENCY_PAIR
UGXXOF=X	UGX/XOF	CCY	CURRENCY_PAIR
UAHUSD=X	UAH/USD	CCY	CURRENCY_PAIR
UYUGBP=X	UYU/GBP	CCY	CURRENCY_PAIR
UGXANG=X	UGX/ANG	CCY	CURRENCY_PAIR
UAH=X	USD/UAH	CCY	CURRENCY_PAIR
UGXTND=X	UGX/TND	CCY	CURRENCY_PAIR
UGXBMD=X	Uganda Shilling (b) vs Bermuda	CCY	CURRENCY_PAIR
UGXDKK=X	UGX/DKK	CCY	CURRENCY_PAIR
UGXIDR=X	UGX/IDR	CCY	CURRENCY_PAIR
UGXISK=X	UGX/ISK	CCY	CURRENCY_PAIR
UYUVEF=X	UYU/VEF	CCY	CURRENCY_PAIR
UGXBRL=X	UGX/BRL	CCY	CURRENCY_PAIR
UGXZWL=X	UGX/ZWL	CCY	CURRENCY_PAIR
UYUMXN=X	UYU/MXN	CCY	CURRENCY_PAIR
ZAR=X	USD/ZAR	CCY	CURRENCY_PAIR
UGXCNH=X	UGX/CNH	CCY	CURRENCY_PAIR
UGXHKD=X	UGX/HKD	CCY	CURRENCY_PAIR
ZMK=X			CURRENCY_PAIR
UGXTHB=X	UGX/THB	CCY	CURRENCY_PAIR
UGXZMW=X	UGX/ZMW	CCY	CURRENCY_PAIR
UGXRSD=X	UGX/RSD	CCY	CURRENCY_PAIR
UYUCLP=X	UYU/CLP	CCY	CURRENCY_PAIR
UGXMYR=X	UGX/MYR	CCY	CURRENCY_PAIR
UAHGBP=X	UAH/GBP	CCY	CURRENCY_PAIR
29134365=X			CURRENCY_PAIR
UGXJPY=X	UGX/JPY	CCY	CURRENCY_PAIR
UGXLKR=X	UGX/LKR	CCY	CURRENCY_PAIR
UYUCOP=X	UYU/COP	CCY	CURRENCY_PAIR
UYUPEN=X	UYU/PEN	CCY	CURRENCY_PAIR
UGXINR=X	UGX/INR	CCY	CURRENCY_PAIR
UGXNZD=X	UGX/NZD	CCY	CURRENCY_PAIR
UGXZAR=X	UGX/ZAR	CCY	CURRENCY_PAIR
UGXEGP=X	UGX/EGP	CCY	CURRENCY_PAIR
UYUUSD=X	UYU/USD	CCY	CURRENCY_PAIR
UGXSGD=X	UGX/SGD	CCY	CURRENCY_PAIR
UYUCHF=X	UYU/CHF	CCY	CURRENCY_PAIR
UGXKYD=X	UGX/KYD	CCY	CURRENCY_PAIR
ZMW=X	USD/ZMW	CCY	CURRENCY_PAIR
UGXTWD=X	UGX/TWD	CCY	CURRENCY_PAIR
UGXTOP=X	UGX/TOP	CCY	CURRENCY_PAIR
UGXCZK=X	UGX/CZK	CCY	CURRENCY_PAIR
29134364=X			CURRENCY_PAIR
UAHEUR=X	UAH/EUR	CCY	CURRENCY_PAIR
UAHCHF=X	UAH/CHF	CCY	CURRENCY_PAIR
UGXMXN=X	UGX/MXN	CCY	CURRENCY_PAIR
UGXNOK=X	UGX/NOK	CCY	CURRENCY_PAIR
UGXHUF=X	UGX/HUF	CCY	CURRENCY_PAIR
UGXARS=X	UGX/ARS	CCY	CURRENCY_PAIR
29134363=X			CURRENCY_PAIR
UGXBWP=X	UGX/BWP	CCY	CURRENCY_PAIR
UGXOMR=X	UGX/OMR	CCY	CURRENCY_PAIR
VUV=X	USD/VUV	CCY	CURRENCY_PAIR
UGXGHS=X	UGX/GHS	CCY	CURRENCY_PAIR
UGXRON=X	UGX/RON	CCY	CURRENCY_PAIR
UYUPYG=X	UYU/PYG	CCY	CURRENCY_PAIR
XDR=X	USD/XDR	CCY	CURRENCY_PAIR
UGXPKR=X	UGX/PKR	CCY	CURRENCY_PAIR
USD=X	USD/USD	CCY	CURRENCY_PAIR
UGXMWK=X	UGX/MWK	CCY	CURRENCY_PAIR
YER=X	USD/YER	CCY	CURRENCY_PAIR
UGXBDT=X	UGX/BDT	CCY	CURRENCY_PAIR
UYUTHB=X	UYU/THB	CCY	CURRENCY_PAIR
WST=X	USD/WST	CCY	CURRENCY_PAIR
UGXBGN=X	UGX/BGN	CCY	CURRENCY_PAIR
XPF=X	USD/XPF	CCY	CURRENCY_PAIR
UGXWST=X	UGX/WST	CCY	CURRENCY_PAIR
29134366=X			CURRENCY_PAIR
UGXVND=X	UGX/VND	CCY	CURRENCY_PAIR
UGXKRW=X	UGX/KRW	CCY	CURRENCY_PAIR
UGXKES=X	UGX/KES	CCY	CURRENCY_PAIR
UGXMUR=X	UGX/MUR	CCY	CURRENCY_PAIR
UGXCOP=X	UGX/COP	CCY	CURRENCY_PAIR
UGXSBD=X	UGX/SBD	CCY	CURRENCY_PAIR
UGXTZS=X	UGX/TZS	CCY	CURRENCY_PAIR
29134361=X			CURRENCY_PAIR
UGXNGN=X	UGXNGN=X	CCY	CURRENCY_PAIR
UAHCZK=X	UAH/CZK	CCY	CURRENCY_PAIR
UGXCLP=X	UGX/CLP	CCY	CURRENCY_PAIR
UGXPHP=X	UGX/PHP	CCY	CURRENCY_PAIR
UGXRWF=X	UGX/RWF	CCY	CURRENCY_PAIR
UGXRUB=X	UGX/RUB	CCY	CURRENCY_PAIR
UGXTRY=X	UGX/TRY	CCY	CURRENCY_PAIR
UGXILS=X	UGX/ILS	CCY	CURRENCY_PAIR
UGX=X	USD/UGX	CCY	CURRENCY_PAIR
UYUEUR=X	UYU/EUR	CCY	CURRENCY_PAIR
UGXKZT=X	UGX/KZT	CCY	CURRENCY_PAIR
UYU=X	USD/UYU	CCY	CURRENCY_PAIR
UGXAUD=X	UGX/AUD	CCY	CURRENCY_PAIR
UGXNAD=X	UGX/NAD	CCY	CURRENCY_PAIR
UYUARS=X	UYU/ARS	CCY	CURRENCY_PAIR
VEF=X	USD/VEF	CCY	CURRENCY_PAIR
XAF=X	USD/XAF	CCY	CURRENCY_PAIR
UGXFJD=X	UGX/FJD	CCY	CURRENCY_PAIR
UGXAFN=X	UGX/AFN	CCY	CURRENCY_PAIR
VUVUYU=X	VUV/UYU	CCY	CURRENCY_PAIR
VUVBOB=X	VUV/BOB	CCY	CURRENCY_PAIR
VNDJPY=X	VND/JPY	CCY	CURRENCY_PAIR
VEFUSD=X	VEF/USD	CCY	CURRENCY_PAIR
VEFARS=X	VEF/ARS	CCY	CURRENCY_PAIR
VUVMAD=X	VUV/MAD	CCY	CURRENCY_PAIR
VEFPEN=X	VEF/PEN	CCY	CURRENCY_PAIR
VUVEGP=X	VUV/EGP	CCY	CURRENCY_PAIR
VEFMXN=X	VEF/MXN	CCY	CURRENCY_PAIR
29134369=X			CURRENCY_PAIR
VEFXDR=X	VEF/XDR	CCY	CURRENCY_PAIR
VUVCHF=X	VUV/CHF	CCY	CURRENCY_PAIR
VEFCHF=X	VEF/CHF	CCY	CURRENCY_PAIR
VUVZAR=X	VUV/ZAR	CCY	CURRENCY_PAIR
VUVCLP=X	VUV/CLP	CCY	CURRENCY_PAIR
VEFCAD=X	VEF/CAD	CCY	CURRENCY_PAIR
VUVCOP=X	VUV/COP	CCY	CURRENCY_PAIR
VEFCLP=X	VEF/CLP	CCY	CURRENCY_PAIR
VEFBRL=X	VEF/BRL	CCY	CURRENCY_PAIR
VEFBOB=X	VEF/BOB	CCY	CURRENCY_PAIR
VEFPYG=X	VEF/PYG	CCY	CURRENCY_PAIR
VNDKRW=X	VND/KRW	CCY	CURRENCY_PAIR
VEFCOP=X	VEF/COP	CCY	CURRENCY_PAIR
VUVEUR=X	VUV/EUR	CCY	CURRENCY_PAIR
VUVUSD=X	VUV/USD	CCY	CURRENCY_PAIR
29134371=X			CURRENCY_PAIR
VUVVEF=X	VUV/VEF	CCY	CURRENCY_PAIR
VUVGBP=X	VUV/GBP	CCY	CURRENCY_PAIR
VUVILS=X	VUV/ILS	CCY	CURRENCY_PAIR
29134368=X			CURRENCY_PAIR
VUVNGN=X	VUV/NGN	CCY	CURRENCY_PAIR
VUVARS=X	VUV/ARS	CCY	CURRENCY_PAIR
VUVMUR=X	VUV/MUR	CCY	CURRENCY_PAIR
VUVJOD=X	VUV/JOD	CCY	CURRENCY_PAIR
VUVZWL=X	VUV/ZWL	CCY	CURRENCY_PAIR
VEFTHB=X	VEF/THB	CCY	CURRENCY_PAIR
VUVPEN=X	VUV/PEN	CCY	CURRENCY_PAIR
VUVSAR=X	VUV/SAR	CCY	CURRENCY_PAIR
VUVMXN=X	VUV/MXN	CCY	CURRENCY_PAIR
VUVBMD=X	VUV/BMD	CCY	CURRENCY_PAIR
VEFEUR=X	VEF/EUR	CCY	CURRENCY_PAIR
VUVCAD=X	VUV/CAD	CCY	CURRENCY_PAIR
VUVBRL=X	VUV/BRL	CCY	CURRENCY_PAIR
VEFGBP=X	VEF/GBP	CCY	CURRENCY_PAIR
29134370=X			CURRENCY_PAIR
VUVAED=X	VUV/AED	CCY	CURRENCY_PAIR
VEFUYU=X	VEF/UYU	CCY	CURRENCY_PAIR
WSTEUR=X	WST/EUR	CCY	CURRENCY_PAIR
WSTUSD=X	WST/USD	CCY	CURRENCY_PAIR
WSTGBP=X	WST/GBP	CCY	CURRENCY_PAIR
WSTCHF=X	WST/CHF	CCY	CURRENCY_PAIR
ZARUSD=X	ZAR/USD	CCY	CURRENCY_PAIR
XOFGHS=X	XOF/GHS	CCY	CURRENCY_PAIR
XDRGBP=X	XDR/GBP	CCY	CURRENCY_PAIR
XCDEUR=X	XCD/EUR	CCY	CURRENCY_PAIR
29134372=X			CURRENCY_PAIR
XAFDKK=X	XAF/DKK	CCY	CURRENCY_PAIR
XDRUSD=X	XDR/USD	CCY	CURRENCY_PAIR
XPFEUR=X	XPF/EUR	CCY	CURRENCY_PAIR
XPFCAD=X	XPF/CAD	CCY	CURRENCY_PAIR
XPFUSD=X	XPF/USD	CCY	CURRENCY_PAIR
ZARCHF=X	ZAR/CHF	CCY	CURRENCY_PAIR
XCDUSD=X	XCD/USD	CCY	CURRENCY_PAIR
ZAREUR=X	ZAR/EUR	CCY	CURRENCY_PAIR
XDRDKK=X	XDR/DKK	CCY	CURRENCY_PAIR
XPFCHF=X	XPF/CHF	CCY	CURRENCY_PAIR
XDRNOK=X	XDR/NOK	CCY	CURRENCY_PAIR
XPFGBP=X	XPF/GBP	CCY	CURRENCY_PAIR
XCDCAD=X	XCD/CAD	CCY	CURRENCY_PAIR
XOFDKK=X	XOF/DKK	CCY	CURRENCY_PAIR
XCDCHF=X	XCD/CHF	CCY	CURRENCY_PAIR
XDREUR=X	XDR/EUR	CCY	CURRENCY_PAIR
XCDDKK=X	XCD/DKK	CCY	CURRENCY_PAIR
XCDGBP=X	XCD/GBP	CCY	CURRENCY_PAIR
YERTHB=X	YER/THB	CCY	CURRENCY_PAIR
ZARTWD=X	ZAR/TWD	CCY	CURRENCY_PAIR
ZARRSD=X	ZAR/RSD	CCY	CURRENCY_PAIR
ZARMUR=X	ZAR/MUR	CCY	CURRENCY_PAIR
ZARLSL=X	ZAR/LSL	CCY	CURRENCY_PAIR
ZARHRK=X	ZAR/HRK	CCY	CURRENCY_PAIR
ZARKRW=X	ZAR/KRW	CCY	CURRENCY_PAIR
ZARMWK=X	ZAR/MWK	CCY	CURRENCY_PAIR
ZARPLN=X	ZAR/PLN	CCY	CURRENCY_PAIR
ZARAOA=X	ZAR/AOA	CCY	CURRENCY_PAIR
ZMWCAD=X	ZMW/CAD	CCY	CURRENCY_PAIR
ZARISK=X	ZAR/ISK	CCY	CURRENCY_PAIR
ZARINR=X	ZAR/INR	CCY	CURRENCY_PAIR
ZMWEUR=X	ZMW/EUR	CCY	CURRENCY_PAIR
ZARILS=X	ZAR/ILS	CCY	CURRENCY_PAIR
ZAREGP=X	ZAR/EGP	CCY	CURRENCY_PAIR
ZARPHP=X	ZAR/PHP	CCY	CURRENCY_PAIR
ZARLVL=X	ZAR/LVL	CCY	CURRENCY_PAIR
29134374=X			CURRENCY_PAIR
ZMWCHF=X	ZMW/CHF	CCY	CURRENCY_PAIR
ZARXDR=X	ZAR/XDR	CCY	CURRENCY_PAIR
ZARCNY=X	ZAR/CNY	CCY	CURRENCY_PAIR
ZMWDKK=X	ZMW/DKK	CCY	CURRENCY_PAIR
ZARSZL=X	ZAR/SZL	CCY	CURRENCY_PAIR
ZARBRL=X	ZAR/BRL	CCY	CURRENCY_PAIR
ZARPKR=X	ZAR/PKR	CCY	CURRENCY_PAIR
ZARIDR=X	ZAR/IDR	CCY	CURRENCY_PAIR
ZARLKR=X	ZAR/LKR	CCY	CURRENCY_PAIR
ZARTRY=X	ZAR/TRY	CCY	CURRENCY_PAIR
ZARBWP=X	ZAR/BWP	CCY	CURRENCY_PAIR
ZARNGN=X	ZAR/NGN	CCY	CURRENCY_PAIR
ZARLTL=X	ZAR/LTL	CCY	CURRENCY_PAIR
ZMWUSD=X	ZMW/USD	CCY	CURRENCY_PAIR
ZARRUB=X	ZAR/RUB	CCY	CURRENCY_PAIR
ZMWJPY=X	ZMW/JPY	CCY	CURRENCY_PAIR
ZARGHS=X	ZAR/GHS	CCY	CURRENCY_PAIR
ZARDKK=X	ZAR/DKK	CCY	CURRENCY_PAIR
ZARSCR=X	ZAR/SCR	CCY	CURRENCY_PAIR
ZARCZK=X	ZAR/CZK	CCY	CURRENCY_PAIR
ZARSAR=X	ZAR/SAR	CCY	CURRENCY_PAIR
ZARKWD=X	ZAR/KWD	CCY	CURRENCY_PAIR
ZARUGX=X	ZAR/UGX	CCY	CURRENCY_PAIR
ZMWGBP=X	ZMW/GBP	CCY	CURRENCY_PAIR
ZARHUF=X	ZAR/HUF	CCY	CURRENCY_PAIR
ZARKES=X	ZAR/KES	CCY	CURRENCY_PAIR
ZARTND=X	ZAR/TND	CCY	CURRENCY_PAIR
ZARCLP=X	ZAR/CLP	CCY	CURRENCY_PAIR
ZARMXN=X	ZAR/MXN	CCY	CURRENCY_PAIR
ZARAED=X	ZAR/AED	CCY	CURRENCY_PAIR
ZARMAD=X	ZAR/MAD	CCY	CURRENCY_PAIR
ZAROMR=X	ZAR/OMR	CCY	CURRENCY_PAIR
ZARTHB=X	ZAR/THB	CCY	CURRENCY_PAIR
ZARQAR=X	ZAR/QAR	CCY	CURRENCY_PAIR
ZARUAH=X	ZAR/UAH	CCY	CURRENCY_PAIR
29134373=X			CURRENCY_PAIR
ZARJOD=X	ZAR/JOD	CCY	CURRENCY_PAIR